낯선	незнакомый
한때	когда-то; в своё время
닥치다	приблизиться
붙잡다	вцепиться
기꺼이	с удовольствием
마르다	сухой
우물	колодец
돌멩이	камешек
한결같이	неизменно
요령	главная мысль
도무지	совсем; совершенно; вовсе
영문	причина; обстоятельство
영문을 모르다	모르다 не знать, в чём дело
엉터리	вздор
허용	азрешение; позволение
귀를 기울이다	기울이다 внимательно слушать (букв. склонив ухо)
절반	половина
진지	~하다 искренний
골판지	гофрированная бумага
빽빽히	тук-тук, бип-бип
채우다	запирать
연상하게 하다 	하다 навевать ассоциацию
먼지를 털다 	털다 стряхивать пыль
철썩 때리다	때리다 шлепнуть
들판	поле
풀다	выпускать (из закрытого прост-ва)
행방	местонахождение
도토리	желудь
뽑히다	быть избранным
콩쿠르	конкурс
챔피언	чемпион
토성	Сатурн
금성	Венера
대단히	очень
굉장히	очень
신음	呻吟 стон
점거	захват, оккупация
사상	идея мысль
냉수	хол. вода
급탕	подача гор. воды
설비를 갖추다 	갖추다 оборудовать
조그맣다	조그마 маленький
경륜장	спортивный велотрек, 경륜 велогонка
천국	рай
수염을 깎다	 брить бороду/лицо
마음이 내키는 대로	내키는 대로 как душе нравится
실컷	вволю
장거리	длинная дистанция
날이 저물다	저물다 вечереть
기동대	маневренный отряд
진입	вторжение
조화	гармония
환상	фантазия
둘러싸다	окружать что-то
훈훈하다	теплый
전설	легенда
위태롭게	наспех
희미하다	слабый, смутный
고지대	возвышенность
권하다	предлагать что-то кому-то
맥주를 따라다	 налить пиво кому-то
미지근하다	тепловатый
인력	гравитация
뱉다	выплюнуть
쪼가리	кусок, клочок
녀석	парень, чуван
작살나다	раздробиться
지옥	ад
2초를 두다	두다 выдержать 2с (паузы)
과연	вправду, действительно
맞장(를) 구치다 	поддакивать
터득	~하다 понимать; усваивать
엄청나다	огромный, непомерный
좀더	немного
혁명	революция
비축	-하다 запасать что-то
떠오르다	всплывать, приходить в голову
완만하다	медленный, пологий
일렁이다	покачиваться (на волнах)
도 빼놓지 않다 	всё без исключения
따스하다	теплый
라운지	вестибюль
턱을 괴다	괴다 подпирать щеку
잇다	продолжать
참을성있게 	терпеливо
느릿느릿	медленно
마주보다	смотреть друг на друга
담배꽁초	окурок
가득 차다	차다 полный до краев
명암	свет и тьма
선을 긋다	긋다 чертить линию
강의 요강	요강 конспект лекций
품에 안다 	안다 держать подмышкой
뇌수	мозг
틈	трещина, зазор
시종	постоянно
부딪히다	столкнуться 와 - с кем-то, 에 на кого-то
투덜거리다	ворчать, бормотать
아무튼	в любом (никаком с отрицанием) случае
일직선	прямая линия
보잘것없다	ничтожный
잠자코	молча
광선	световой луч
멍하니	рассеянно
고개를 끄덕이다	끄덕이다 кивнут головой
로터리	площадь с колцевым движением
덜 깨다	깨다 быть сонным, не проснуться окончательно
미끄럼대	детская горка
그네	качели
모래밭	песочница
입을 다물다 	다물다 замолчать
따분하다	скучный
성적표	табель успеваемости
줄줄이	в ряд
늘어놓다	разложить расставить
흔히	часто
녹이 슬다	슬다 ржаветь
처량하다	грустный, унылый
코를 찌르다	찌르다 бить в ноздри (запах)
맨	самый (с нареч., прил.)
까마득하다	очень далекий
종달새	жаворонок
노랫소리	песня
하품을 하다	하다 зевнуть
권태롭다	апатичный, скучный (настроение)
반복	повторение
에 지나지 않다	지나지 않다 всего лишь
되풀이	повторение ~하다
소변 보다	보다 мочится
문지르다	тереть что-то о что-то
벅벅	звук царапания, скрежета
느슨하다	нетугой, слабый
느슨하게 하다 	하다 ослабить
덜다	ослабить (боль, страдание)
통증	боль
그다지	не настолько, не так уж
절단하다	разрезать, отрезать
위화감	чувство неконгруэнтности, несоответствия
뒤섞다	перемешивать, перетасовывать
뒤섞이다	быть перемешанным
짜맞추다	собирать из частей
더욱	еще больше
악화되다	ухудшаться
양옆에	по обе стороны
이윽고	спустя некоторое время
주섬주섬	один за одним
커피를 끓이다	끓이다 варить кофе
토스트를 굽다	굽다 жарить тосты
솜씨	умение ловкость
철조망	проволочная сеть
기관총을 쏘다	 стрелять из пулемета
참으로	действительно
숙취	похмелье
대꾸	ответ
마주	앉다 сидеть напротив друг друга
제안	предложение (что-то кому-то)
마음대로	по душе, как нравится
번갈아	по очереди, один за другим
점검	проверка, осмотр
한층	еще больше
가까스로	едва, с трудом
덧붙이다	добавить к чему-то
우체통	почтовый ящик
쥐덫	мышеловка
미끼	приманка
온	весь целый (прил.)
뒤지다	обшарить что-то
조각	обрывок
면세점	дьюти фри
구르다	кататься
굴러다니다	кататься туда сюда
끼이다	застрять где-то 에
교훈을 주다	주다 преподать урок
교훈을 얻다	 извлекать урок
반드시	обязательно
뻗다	растянуться
아득히	вдали
칙칙하다	темный, тусклый
잡목림	смешанный лес
구기다	морщить, смять
영원히	вечно
진절머리가 나다	 надоедать кому чем
몸을 쭉 펴다 	потянуться
실로	действительно
몽롱하다	тусклая
감싸다	обертывать, покрывать
미세하다	микроскопический
대기	атмосфера, воздух
들키다	быть замеченным 게/에게
면하다	быть обращенным к 에
경사면	наклонная плоскость, склон
궤도	колея, орбита
빠져나가다	를 выйти/вырваться из замкнутой области
뻐꾸기	кукушка
가로지르다	пересечь
기복	неровность, рельеф
일렬	линия, колонна
줄지다	выстраиваться в линию
양지바르다	солнечный, обращенный к солнцу
웅크리다	свернуться, съежиться
눈길을 끌다	끌다 приковать глаза
하품이 나오다	나오다 наводить зевоту (о чем-то скучном)
단선	одноколейка
뜰	сад перед домом
헛간	амбар, сарай
시달리다	에 подвергаться чему, мучиться от
선전	пропаганда, реклама 하다
양철	жесть
유치	привлекать, приманивать 하다
양옥	дом в европ. стиле
굵직하다	довольно крупный
꼼꼼하게	тщательно
양질	высококачественный
목재	лесоматериалы
덕택에	благодаря
묵직하다	увесистый, солидный
중량감이 있다	увесистый
칠하다	выкрасить
녹다	растворится в 에
연못	лотосовый пруд
아담하다	благородный; элегантный
팔각형	восьмиугольник
정자	беседка
돌출하다	выдаваться вперёд
만발하다	обильно цвести
설계자	дизайнер
거주자	жилец
나이 들다	быть пожилым
폐병	легочная болезнь
속으로 스며들다	проникать, впитываться внутрь
뒤덮다	сплошь покрывать
달콤하다	сладковатый
습하다	сырой
강가	берег реки
저지대	низина
에워싸다	обступать, окружать
까다롭다	привередливый
천재	талант
의뢰	поручение
긁다	царапать, скрести
부지	участок земли, на кот. постройка
냄새를 맡다	нюхать
지점	место на земле
찾아내다	отыскать
인부	чернорабочий
십중팔구	наверняка, 8-9 из 10
전철에 치다	быть сбитым электричкой
억수	ливень
난청	тугоухость
시체	труп
조각나다	разрезать на кусочки
흩어지다	разлететься, рассыпаться по 에
회수하다	возвращаться
갈퀴	грабли
달리다	прикреплять к 에
막대기	палка
굶주리다	голодать
들개	бродячая собака
양동	ведро
폐가	заброшенный дом
에 걸쳐(서)	на протяжении (время)
마음을 가라앉히다	успокаивать душу
친한 친구	близкий друг
고서	старинная лит-ра/книга
타락	моральное падение
천사	ангел
파계승	грешный монах
악마 추방자	изгонитель дьявола
흡혈귀	вампир
잡지에 실린	помещенный в журнал
풍모	внешность, вид
힘차게	энергично
막연하다	неопределённый; смутный
제정	империя, монархия
사상범	вольнодумец-преступник
유형지	место ссылки
전기	биография
바퀴	таракан
순록	сев. олень
썰매	сани
어둠을 틈타다	пользуясь темнотой (удобным случаем) под покровом темноты
탈주	побег
꽁꽁 얼다	промерзать
은백색	серебряный
황야	пустыня
전속력으로	на полном ходу
숨결	дыхание
발굽	копыто
사방	пустыня
흩날리다	разметаться
쓰러지다	повалиться
피로에 지치다	утомленный усталостью
끌어안다	обнимать
마음속으로 맹세하다	покляться в душе
정의	справедливость
동상	бронзовая статуя
동서남북	все 4 стороны
파괴	уничтожение
산중턱	склон горы
시냇물	ручей
비둘기	голубь
에 눈을 뜨다	проснуться от
열매	плоды
잎사귀	листва
껍질을 벗기다	снять обертку
쓰다듬다	гладить (рукой тд.)
힘껏	изо всех сил
타이르다	убеждать кого-то 를
태반	большая половина
타인	чужой/чужак
원망	сетование, жалоба
경멸	презрение
험담	злословие
오로지	только
애정	любовь
배려	сочувствие
정어리	сардина
통조림	консервы
나란히	ряд; рядом; ровно; рядком
드러눕다	улечься
짐작이 가다 	догадываться о дэхэ
생애	жизнь
황금	золото
지상	поверхн-ть земли
도입	внедрение
웅덩이	яма с водой
사다리	лестница
채색	окраска
색채	цвет
마음이 훈훈해지다	тронуть душу
유별나다	особенный
씌어지다	написанный (книга)
초상화	портрет
배은망덕	неблагодарность хада
부당	несоответств-я
해소	развеяться
자극	стимулировать
요소	важный пункт
후광	ореол
자본 투자	инвестор капитала
지탱	поддерживать
근원	фундаментальный
진흙	грязь
기량	способности
십진법	десятичный
환산	вести счет
형이상학적	метафизический
학파	течение школа
자존심	чувство собств достоинства
대치	замена
다만	только, лишь
귀중	дорогой
소모전	война на истощение
고독	одинокий
용기	смелось
추적	погоня
통찰	проницательность
변혁	преобразование
확대	расширение
축소	сужение
포괄	содержание охват
지향	устремление  을 ставить целью
반칙	нарушение правил
보복	возмездение
가차없다	безжалостный
손을 들다	умыть руки от бессилия
끔찍하다	поразительный ужасный
혼란에 빠지다	тронуться умом
평온	мир спокойстиве хада
구별	различие
어깨를 으쓱하다	пожать плечами
띄게	заметно
퇴보	регрессия
세포	клетка
분열	разделение
중견급	основной класс
시간도 아끼다	даже жалеть время на что-то
초주검이 되다	быть на гране смерти, без сил
그런 까닭에	по этой причине
차례차례	один за другим
교배	скрещивание хада
점차	постепенно
수도꼭지	водопроводный кран
구불구불하다	извилистый
수초	трава и водоросли
무성하다	густрой, разросшийся
이따금	то и дело, часто
낚시줄을 드리우다	закинуть удочку
낚시꾼	рыбак
데리다	брать с собой (кого-то)
울타리	изгородь
애처롭다	жалкий
손가락을 튕기다	щелкнуть пальцами
들이밀다	просунуть что-то куд
길다랗다	продолговатый
뒤로 물러나다	отсупить назад
뒤를 돌아다보다	посмотреть назад
울타리를 빠져 나오다 	 пролезть через забор
프린트되다	быть напечатанным
젖꼭지	сосок
개업	business opening
선착순으로	В порядке прибытия