있다	To be
가꾸다	1. выращивать; взрастить; культивировать; разводить 2. украшать; декорировать; отделывать
가다	To go
가라앉다	1. тонуть; затонуть 2. успокаивать; успокоить; умиротворять; униматься
가로막다	мешать; препятствовать; устраивать обструкцию; быть помехой
가르다	1. делить; разделять; разъединять; распределять; раздавать; разбирать; сортировать; классифицировать 2. отличать, различать, выделять, относиться по-разному 3. пробиваться, прокладывать себе путь
가르치다	To teach
가리다	1. выбирать; отбирать; разбирать; перебрать; распределять по сортам; рассортировать
가리다	4. нагромождать, навалить, подваливать, складывать в кучу
장작을 가려 놓다 сложить дрова в кучу
가리키다	указывать; показывать; указать
가만있다	1)оставаться спокойным сидеть 2)без движения быть 3)в состоянии покоя
가져가다	To take or  carry
가져다주다	Take something to someone
가져오다	To bring or  get
가지다	To have or  take or  hold
가지다	Entertain or  hold or  have
갖다	To hold 가지다
갇히다	быть (находиться) в заточении (взаперти)
갈다	1) точить; заострять; править (бритву); 2) молоть; перетирать;  3) make juice in a mixer 문지르다
갈다	1. заменять; менять; 바꾸다
갈아입다	Change one’s clothes
갈아타다	Transfer (bus or subway)
감다	закрывать глаза 눈을 ~
감다	3. обматывать; наматывать; бинтовать; заводить (часы) 실을 ~
감싸다	1. обертывать; завертывать 2. покрывать; брать под защиту
감추다	прятать; скрывать; утаивать
갖추다	иметь; подготавливать; держать; приводить в порядок;
갚다	возвращать (долг); отплачивать; возмещать;
개다	прояснеть; 날이 ~ разводить; убирать постель
거두다	собирать; убирать; приводить в порядок;
거들다	помогать; вмешиваться; вставлять слово
거치다	заходить за что; заезжать за что; преодолевать;
건너다	Go over or  go across
건너가다	To cross or  go over (river or  street)
건너오다	To come across to this side of something
건네주다	To pass over or  to put on the other side (of a river)
건네다 	перевозить (на другой берег); передавать
건네다	Speak to a person or  address; перекидываться (словами; шутками)
건드리다	1) touch or  jog  2) irritate or  vex
건지다	(из воды) вынимать; вытаскивать
걷다	1) Roll back /up one’s sleeves 소매를 ~ 2)fold or  furl up  3) finish work 
걷다	Walk on or  tread on, 느릿느릿 ~
걸어가다	To go on foot or  walk
걸어오다	Come on foot or  walk 집까지 ~
걸다	Hang up or  suspend 옷을 ~
걸리다	To be hung up or  suspended 걸다'의 피동사
걸치다	1) put a thing over or across 2) to range from A to B
겪다	Experience or  undergo or  suffer
견디다	Endure or  bear
계시다	(someone esteemed) to stay or  be located
고르다	выбирать
고치다	To fix, amend, change
구르다	1. катиться 바위가 ~ 2. топать
굳히다	делать твёрдым (прочным); укреплять
굶다	To starve or  go hungry
굽다	To roast or bake 익히다
굽히다	сгибать; гнуть; искривлять; нагибать; уступать
그려지다	Draw
그리다	Picture or  draw a picture 그림을 ~
그만두다	бросить что делать; перестать; оставить
그치다	прекращать(ся); приостанавливать(ся); кончать(ся); переставать; ограничиваться
긁다	царапать, чесать 2) отскребать 3)сгребать, загребать что-либо 4)клеветать на кого-либо, порочить кого-либо
긋다	1)проводить линию (параллель) 2)чиркать (спичкой)
기다	1. ползать; ползти; расползаться 2. пресмыкаться, раболепствовать; низкопоклонничать
기다리다	To wait
기대다	1. опираться; прислоняться; покоиться 2. надеяться на; быть уверенным; полагаться;
기르다	выращивать; выхаживать; откармливать; воспитывать;
기울다	покоситься; наклониться; склониться;
기울이다	склонять; наклонять; сосредотачивать
괴롭히다	мучить
까다	1. очищать; чистить (кожуру); 2. выводить (цыплят); 3. бить; сильно избивать;
까먹다	очищать и есть
깎다	1. строгать; обтачивать; стричь; брить;  2. сбавлять; уменьшать 3. портить; порочить
깔다	подстилать; стелить; давить
깔리다	быть подстеленным (разостланным; расстеленным)
깨다	1. пробуждаться; проснуться; очнуться; прийти в себя; протрезвляться 2. постигнуть; понять; быть просвещённым
깨어나다	Return to consciousness
깨어지다	To waken
깨우다	To wake up or awaken
깨닫다	to realize sth
깨다	1. разбивать; ломать; 2. наносить рану; ранить 3. нарушать; подрывать
깨뜨리다	1. разбивать; ломать 2. нарушать; срывать;
깨지다	откалываться; проламываться; лопаться;
꺼내다	1.извлекать; вынимать; 2. начинать разговор;
꺼지다	1. потухать; гаснуть 2. исчезать 3. проваливаться
꺾다	1. ломать; рвать 2. менять направление 3. перегибать пополам; складывать вдвое 4. подавлять; сдерживать; перебивать; не давать говорить 5. сгибать; подгибать; перебивать
꼽히다	To be elected
꽂다	втыкать; всовывать;
꾸다	брать в долг (взаймы) 돈을 ~
꾸다	видеть сон; видеть во сне что-либо; мечтать; думать 꿈을 ~ 
꿈꾸다	видеть сон
꾸리다	1. заворачивать; завязывать; паковать; укладывать вещи; связывать в узел; обвернуть; собирать вещи 2. руководить; управлять; владеть; управиться; обставлять; укреплять
꾸미다	1. украшать; декорировать 2. шить 3. притворяться кем-либо; врать; приукрашивать 4. составлять; организовывать 5. задумывать; замышлять
끄다	гасить; выключать; гасить 불을 ~
끄덕이다	кивать; покачивать
끊기다	To be cut off or  severed
끊다	1.резать; разрезать 2. обрезывать; отрезать 3. покупать; купить 4. убивать 5. бросать; останавливаться
끊어지다	To break off or  expire or  be done with
끌다	тащить; тянуть; волочить;
끌리다	To be drawn or  pulled or  dragged
끌어당기다	притягивать; тянуть
끓다	варить
끓이다	Boil or  heat or  make hot
끝나다	To draw to a close or  to end
끝내다	To end
끼다	2. вставлять; вкладывать; помещать; надевать; омывать; прибегать к помощи; использовать в своих интересах; дополнять; добавлять; присоединять
끼다	1. заволакиваться; садиться; покрываться чем; зарастать; появляться на лице; звучать голосе
끼어들다	intrude into[upon]; wedge (oneself) in(to); thrust oneself into;
끼우다	вставлять; вкладывать; втыкать; допускать к участию в чём
나다	To come out, grow, spring up
나가다	To go out
나가다	To advance, proceed, go forward
나서다	Come out, come forth
나아가다	Advance, go forward
나오다	Come out
나누다	To divide
나누어지다	To become divided
나뉘다	be[get] divided; be separated; be split up; be classified
나다	To be born
나르다	возить, перевозить; носить; переносить
나타나다	выражаться; проявляться; появляться;
나타내다	выражать; проявлять; показывать; обнаруживать
날다	To fly
날리다	To send flying 날다'의 사동사
날아가다	To fly away
날아다니다	Fly about
날아오다	Come flying
남기다	To leave behind
남다	Remain, be left over
낫다	поправляться; заживать; улучшаться; проходить 병이 ~
낮추다	понижать; снижать; занижать; убавлять;
낳다	рожать; порождать; вызывать; прясть
내다	to see through, to make it through sth 참아 ~
내다	produce something 길을 ~
내다보다	выглядывать; смотреть вперёд (вдаль);
내리다	Descend 눈이 ~
내려가다	To go down
내려놓다	Set or put down
내려다보다	смотреть сверху вниз; смотреть, потупив взор;
내려오다	Come down
내려지다	To become lower
내밀다	To Push out
내버리다	Throw away
내놓다	Put out, take out
내보내다	Let out, let go out
내쉬다	Exhale
내주다	Take out and give away
넓히다	Widen
넘겨주다	Hand over
넘기다	Pass over, send across
넘다	Cross or go across
넘어가다	Cross or go over
넘어뜨리다	Throw down
넘어서다	Pass over
넘어오다	Fall, come down
넘어지다	Fall down, collapse
넘치다	Overflow
넣다	класть (во что); вкладывать; вставлять (во что);
녹다	To melt
녹이다	Melt, dissolve
놀다	играть; гулять; отдыхать; не работать
놀라다	Be surprised
놀리다	давать отдых; давать поиграть (погулять); подшучивать (над кем); 흉을 보다
높이다	Raise, elevate
놓다	класть; ставить; устанавливать;
놓아두다	Leave as it is, let it be
놓이다	быть отпущенным; быть освобождённым; успокаиваться ;лежать (на чём)
놓치다	Miss, let slip
놔두다	Leave as it is, let it be 놓아두다
누르다	Press or push down 힘을 가하다
눈감다	Close the eyes
눈뜨다	Open one’s eyes
눕다	ложиться; лежать
느껴지다	Feel
느끼다	To feel 추위를 ~
늘다	Increase, gain
늘리다	Increase, multiply
늘어나다	Grow longer
늘어놓다	(1) Scatter about haphazardly ; (2) 으로 늘어놓다  to arrange, place in order
늘어서다	Stand in a row
늙다	Grow old
늦다	Be late, overdue
다가가다	To get near to
다가서다	Step up, go near to, come closer
다가오다	Approach
다니다	Go to and from a aplace
다녀가다	Drop in for a short visit
다녀오다	Drop in for a short visit
다듬다	упорядочивать; приводить в порядок; перебирать; чистить; подрезать;
다루다	обращаться с кем-чем; управлять чем;
다지다	утрамбовывать; укреплять; принять решение;
다치다	ушибить; поранить; трогат
다투다	ссориться с кем; спорить о ком-чём;
다하다	иссякать; истощаться; исчерпывать; использовать до конца; завершать; выполнять
닥치다	наступать, нагрянуть
닦다	стирать; вытирать; протирать
닫다	To close
닫히다	To shut, be closed
달다	to attach, fix 단추를 ~
달라지다	To change, vary
달래다	Calm down
달리다	run, make do fast 말을 ~
달려가다	Run, rush, dash
달려들다	Run, rush, jump at
달려오다	Come running
달아나다	Escape, flee
달리다	Hang, be supsended 문에 종이 ~
달다	To hang 무게를 ~
닮다	быть похожим (сходным)
담그다	погружать (в жидкость); солить
당기다	Pull
닿다	To reach, get to
대다	докладывать признаваться трогать снабжать сравнивать;귀에 ~
더불다	Join in, do together
더하다	Get worse
던지다	To throw
덜다	Save, lighten
덧붙이다	добавлять, прикреплять
덮다	To cover, veil
덮이다	Be covered
데려가다	Take with
데려오다	Go with
데리다	брать с собой
데우다	to warm, to heat up
도와주다	To help
되돌아보다	To look back on
들다	входить приступать требоваться возникать наступать совершать держать поднимать приводить кушать Means continuing the main verb’s action ;
들려오다	To echo (sound)
떠나오다	미국으로부터 to come back from the US
마르다	Become dry
마시다	To drink
마음먹다	Be determined to
마주치다	Collide with
마치다	кончать; заканчивать упираться; наталкиваться
막다	закрывать; затыкать; преграждать  запрещать отстоять
막히다	Be stopped up
만나다	Meet
만들다	To make
만들어지다	Make, create
만지다	To touch
말다	Cease 그만두다
말다	свёртывать, разбавлять, не делать, воздержаться ... 감다
말리다	отговаривать; не советовать унимат 싸움을 ~
말리다	сушить; высушивать; вялить, 빨래를 ~
말씀드리다	Speak (honor.)
말하다	Speak
맛보다	Taste
망설이다	Hesitate
망치다	亡－ (по)губить; приводить в негодность
맞다	Be right, correct; to match, be fitting for 답이 ~
맞다	Be struck,beaten 매를 ~
맞다	receive,welcome (note, usually this is 맞히다) 손님을 ~
맞서다	Stand opposite
맞이하다	Go to greet
맞추다	Adjust, adapt
맡기다	поручать кому; доверять;
맡다	брать на себя; принимать; получать; 담임을 ~
맡다	Smell 냄새를 ~
매다	завязывать; связывать 끈을 ~
매달리다	висеть; быть подвешенным; быть прикрепленным; быть добавленным (приложенным); быть привязанным (прикованным); опираться; полагаться; зависеть
매달다	вешать; подвешивать; приковывать; привязывать:  묶어서 드리우거나 걸다.
메우다	To carry,attach;put on 메다'의 사동사
맺다	завязывать; вязать
머무르다	останавливаться; топтаться на месте; ограничиваться
머물다	останавливаться; топтаться на месте; ограничиваться
먹고살다	Make one’s living
먹다	есть; курить; вдыхать  밥을 ~
먹다	оглохнуть 귀를 ~
먹이다	заставлять кого; есть (пить); угощать; кормить; поить;
먹히다	быть съеденным (выпитым); быть полученным
멈추다	прекращать(ся); переставать; останавливать(ся)
멎다	переставать; прекращаться; останавливаться
메다	брать (на плечи)нести (на плечах) 총을 ~
모르다	To not know
모시다	заботиться; почитать; поклоняться; провожать; сопровождать; помещать; устраивать
모여들다	gather,flock
모으다	gather,get together
모이다	Meet, assemble
모자라다	недоставать; не хватать; быть неразвитым
몰다	гнать; сгонять; загонять; отгонять; отпугивать
몰려들다	быть загнанным; входить гурьбой (толпой)
몰려오다	прийти гурьбой; подбежать гурьбой
무너지다	рушиться; обваливаться; отходит
묵다	быть старым, 오래된 상태
묵다	ночевать; останавливаться. s.w. 머무르다
묶다	связывать; перевязывать
묶이다	Be fastened together
묻다	спрашивать; расследовать 길을 ~
물어보다	Ask
묻다	приставать; прилипать 옷에 흙이 ~
묻다	зарывать; закапывать;прятать 시체를 ~
묻히다	намазывать, обмазывать, обваливать в  옷에 흙을 ~
묻히다	быть закрытым (закопанным, погребённым) 땅에 ~
물다	держать (во рту, в клюве); кусаться; хватать 담배를 ~
물러나다	Fall off
미루다	Postpone ; (2) to guess, infer and make an educated guess
미치다	To reach 닿다
미치다	Be crazy 정신에 이상이 생기다
믿다	Believe
믿어지다	Become believable
밀다	push,shove
밀리다	to be left undone, to be late in making a payment (to fall into arrears) (2) to be pushed, shoved 방세가 ~
바꾸다	change,exchange
바뀌다	Be changed
바라다	Wish, hope
바라보다	Look at, watch ; to look forward to, hope for
바로잡다	Straighten
바르다	Spread, apply 벽지를 ~
박다	Drive,hammer in
박히다	Be nailed in
반기다	Rejoice, be glad of
반짝거리다	Twinkle-twinkle (stars)
반짝이다	Shine, glitter
받다	Receive 선물을 ~
받아들이다	Accept
밝다	To be bright
밝아지다	Become bright
밝혀내다	To find out
밝히다	To light up
밟다	ступать; наступать; топтать
밤새다	To stay up all night
밤새우다	не смыкать глаз всю ночь, провести бессонную ночь
배다	Soak into 땀이 ~
배우다	To learn
뱉다	выплёвывать; выкладывать
버려지다	Take away, throw away to somewhere
버리다	(following a verb) the verb\\'s action is over, perhaps in a sad way
버리다	Throw away
버티다	Endure, tolerate
벌다	To earn (money) ; (2) to invite, to bring onto oneself 돈을 ~
벌리다	Open, wide 입을 ~
벌어지다	To get serious, enlarge 싸움이 ~
벌어지다	Widen, get wider 틈이 ~
벌이다	(1) to plan to start a job/project (2) to play a table game
벗기다	Unclothe, undress
벗다	Take off, remove
베다	Cut, chop 목을 ~
보내다	посылать; отправлять
보내오다	присылать
보다	To see
보다	To try
보살피다	Take care of
보이다	see,catch sight of 보다'의 피동사
보이다	show,let see 보다'의 사동사
볶다	жарить; тушить
뵈다	See (polite) 웃어른을 보다
뵈다	보이다
뵙다	see,meet
부딪치다	сильно удариться; с силой столкнутьс
부딪히다	сталкиваться; разбиваться
부러지다	Break, get broken
부르다	To call 이름을 ~
부서지다	Break, be broken
부치다	to send, to post 편지를 ~
불다	Blow 바람이 ~
불러일으키다	rouse,stir up
불리다	To be called 부르다'의 피동사
불리다	soak,steep 물에 ~
불어오다	Call to come
붐비다	столпиться; набитый народом; срочный; спешный
붓다	to pour (water, liquid) 물을 ~
붓다	распухать; вздуваться; набухать 얼굴이 ~
붙다	Stick, adhere to
붙들다	catch,seize,grasp
붙이다	affix,put on
붙잡다	seize,catch
붙잡히다	крепко держаь(ся); схватиться
비기다	сыграть (закончиться) вничью; составлять баланс.  Same as 무승부를 기록하다
비다	To be empty, vacant
비롯되다	To be begun, to have started
비비다	тереть, растирать; натирать; приправлять
비우다	empty,vacate
비웃다	насмехаться, высмеивать кого-л.)
비추다	освещать; озарять; просвечивать (что-л. лучами); отражаться
비치다	светиться; освещаться; отражаться
비키다	отодвигаться; сторониться
빌다	желать; просит занимать 소원을 ~
빌리다	давать в долг
빛나다	shine,glitter
빠뜨리다	Throw into (a river); entice, entrap
빠져나가다	Get/go out of here
빠져나오다	Come out of somewhere
빠지다	To indulge in, be addicted to 머리가 ~
빠지다	To fall into 물에 ~
빨다	стирать 옷을 ~
빨다	сосать 젖을 ~
빼놓다	exclude,leave out
빼다	Pull out, extract 가시를 ~
빼앗기다	A thing be taken away
빼앗다	отнимать
뺏다	Straight
뻗다	растянуться; слечь
뽑다	выбирать; вытаскивать
뽑히다	быть избранным
뿌리다	sprinkle,scatter
뿌리치다	Shake off, refuse
사귀다	общаться; дружит
사다	To buy, purchase
사들이다	закупать
사라지다	To disappear
살다	To live
살아가다	Lead a life, get along
살아나다	revive,be brought back to life
살아남다	Survive
살아오다	To come out alive
살리다	1) revive, bring around, restore to life  2) save,spare,rescue
살펴보다	Watch closely
살피다	Take a good look at
삶다	варить; кипятить
삼가다	быть осторожным; остерегаться;
삼다	делать (считать) (кого-л, кем-л., чем-л.)
삼키다	глотать; проглатыват
새기다	To sculpt,engrave 문신을 ~
새다	leak,escape from 비가 ~
새우다	не спать ночью 밤을 ~
생기다	arise,occur,happen
생겨나다	To begin, germinate
서다	To stand
서두르다	To hurry up
섞다	blend,mix
섞이다	To be mixed,blended
세다	Count 돈을 ~
세우다	Stand up, erect
세워지다	To become erected
소리치다	To shout, yell
속삭이다	Whisper
속이다	deceive,cheat
손잡다	Take a person by the hand
솟다	rise,soar,tower above
숙이다	Lower one’s head
숨기다	To hide
숨다	To be in hiding, to hide oneself
숨지다	Breathe one’s last breath
쉬다	to relax, take a break 편안히 ~
쉬다	to breathe 숨을 ~
스치다	Graze past 살짝 닿다
시들다	вянуть; увядать
시키다	заставлять (позволять) кого; принуждать делать что
식다	To get cold, cool off
식히다	To cool, let cool. 차게 하다
신다	Put on, wear
싣다	грузить что чем; перевозить
심다	plant,sow (a tree)
싸다	Wrap in, bundle 보자기에 ~
싸우다	To fight
쌓다	To pile up
쌓이다	Be piled/heaped up
썩다	Go bad, rot
썰다	Chip, mince,dice
쏘다	(1) To shoot  (2) to sting, bite (an insect, animal)
쏟다	To pour .  붓다
쏟아지다	To pour out
쓰다	To write 글씨를 ~
쓰이다	писаться; писанный 글이 ~
쓰이다	To be used, to be utilized/employed 농사에 기계가 ~
쓰다	To wear (a hat) 모자를 ~
씌우다	надевать что-либо на кого-либо 아이에게 모자를 ~
쓰다	Take (medicine) 약을 ~
쓰다듬다	Stroke one’s beard
쓰러지다	падать; повалиться; развалиться
쓸다	마당을 ~ brush, sweep perhaps lightly
씹다	To chew
씻기다	To be carried away, washed away 비에 ~
씻기다	wash,be washed 아이를 ~
씻다	To wash,cleanse
아끼다	жалеть; щадить; беречь
안기다	to be embraced by sb (in their arms) 안다'의 사동사
안다	To hold, embrace
안기다	(1) To fix on a person, lay the blame on a person 안다'의 피동사 2 - no match
안되다	Must not, should not 공부가 ~
앉다	To sit down
앉히다	To place a person in a set
않다	To not be, to not do
알다	To know
알려지다	To become known
알리다	To inform, tell a person
알아내다	To find out (e.g. the answer)
알아듣다	To listen and comprehend
알아보다	To investigate, examine, search
알아주다	acknowledge,recognize, appreciate
앓다	To be ill, sick with sth
앞두다	Have a distance ahead
앞서다	To go before, precede
앞세우다	Make a person go
앞장서다	To be in the lead/ at the head
애쓰다	прилагать усилия; стараться
어기다	нарушать; не соблюдать
어리다	увлажняться 눈물이 ~
어울리다	To be becoming, suiting
어쩌다	иногда; по временам; случайно
어찌하다	Be subject to an attack of vertigo (figuratively), to not know what the hell is going on or what to do.
얹다	Put on, place, lay, set
얻다	Get, obtain
얻어먹다	Go about begging
얼다	Freeze, be frozen
얼리다	Freeze, make ice 물을 ~
업다	носить на спине
없애다	Remove, get rid of, do away with
없어지다	To lose, get lost
엇갈리다	Cross, miss eachother
엎드리다	Prostrate oneself, lie on the ground
여겨지다	To look, appear, think of sth as
여기다	Think, consider as
여쭈다	Tell a superior, inform
열다	Open 문을 ~
열리다	плодоносить 열매가 ~
열리다	Open, be opened, be unlocked 문이 ~
엿보다	Wait for an opportunity
오가다	Come and go, keep going and coming
오다	To come
오래되다	To last for a long time
오르내리다	Go up and down, rise and fall
오르다	Go up, climb, ascend
올라가다	To go up, ascend
올라서다	Stand up
올라오다	Come up
올라타다	Board (a plane), get into
올려놓다	Put a thing on a place
올려다보다	Look up
올리다	Raise, lift up
옮기다	Move, transfer (2)(sickness) communicate, transfer to
외다	To repeat back (an order) 주문을 ~
외우다	читать наизусть; декламировать; заучивать
외치다	To shout,scream
울다	плакать; петь 울음을 ~
울리다	звучать; раздаваться (о звуках) 종이 ~
울리다	заставлять плакать 아기를 ~
움직이다	To move, stir
웃기다	To be funny
웃다	To laugh, smile
이기다	To win 적에게 ~
이끌다	тянуть; привлекать; втягивать
이러다	do/say think this way
이루다	создавать; образовывать; составлять; осуществлять
이루어지다	Get accomplished, achieved
이룩하다	Erect, build
이뤄지다	To make something for a specific purpose
이르다	достигать; доходить; добираться 도착하다
이르다	говорить; называть 말하다
이어지다	Get joined, be connected
익다	созревать; поспевать 감이 ~
익숙해지다	привыкнуть к
익히다	варить (на пару) 고기를 ~
익히다	делать умелым (искусным); приучать 기술을 ~
일어나다	происходить; подниматься; вставать
일어서다	подниматься; вставать (на ноги)
읽다	To read
읽히다	To get a person to read, to get a person to learn 읽다'의 피동사
일으키다	поднимать; возбуждать; вызывать
잃다	To lose, to miss, to be deprived
잃어버리다	To lose
입다	To wear 옷을 ~
입히다	Clothe, dress
잇다	соединять; связывать
잇따르다	Follow one after another
있다	To be
잊다	To forget
잊어버리다	To forget
잊혀지다	To become forgotten
자라나다	вырастать; расти
자라다	расти; взрослеть; возрастать 커지다
자르다	разделять; разрезать; разрубать
잘리다	быть отрезанным (отсечённым, отрубленным
잘되다	To turn out well
잘못되다	To turn out wrong
잘살다	To be affluent, well-off
잠그다	запирать; закрывать; погружать 서랍을 ~
잠기다	быть запертым (закрытым); сдавить; сжать; быть погружённым 물에 ~
자다	To sleep
잠들다	Fall asleep
잠자다	Fall asleep
잡다	seize,catch
잡수다	eat,drink
잡수시다	eat,drink
잡아당기다	тащить (к себе); перетягивать (на свою сторону)
잡아먹다	Slaughter and eat
잡히다	To be caught ; to extinguish a fire 잡다'의 피동사
재다	measure,guage 저울로 ~
재우다	Put to sleep 고기를 양념에 ~
저러다	Like that
저지르다	do,commit,spoil
적다	Write down 답을 ~
적히다	To be recorded,written down
접다	Fold up
젓다	грести; махать; размахивать; размешивать
젖다	To be wet, soaked
조르다	To tease, urge sb 요구하다
졸다	doze,take a nap
졸리다	Feel sleepy,drowsy 자고 싶다
좁히다	Make narrow,restrict
주고받다	Give and receive, exchange
주다	To give, to do for a person
주무시다	To sleep (respectful word)
주어지다	To offer, proffer (conditions)
주저앉다	Sit down, plump down
죽다	die,pass away 굶어 ~
죽이다	To kill 굶겨 ~
죽다	Lose your spirit 심심해 ~
줄다	Diminish
줄어들다	Dwindle away
줄이다	reduce,decrease
줍다	Pick up, gather
중얼거리다	Mutter to oneself
쥐다	брать что (в руку); держать что (в руке) 주먹을 ~
즐거워하다	To enjoy it
즐기다	Enjoy oneself,take pleasure,delight
지나가다	To pass, elapse
지나다	pass,elapse,go on
지내다	To pass, spend time
지나치다	Go too far, to go to extremes
지니다	Carry with, hold, possess
지다	Carry (on the back) 등에 ~
지다	Set (the sun) 해가 ~
지다	To lose (at war, a game) 전쟁에 ~
지다	To fade away, come off 그늘이 ~
지르다	Holler, yell, scream 소리를 ~
지우다	вытирать; стирать 낙서를 ~
지우다	Put a thing on a person’s back 짐을 ~
지워지다	To be erased
지치다	Be exhausted, fatigued 일에 ~
지켜보다	Watch, stare at ( wait on some situation)
지키다	Protect, maintain
집다	Pick up
집어넣다	Put in
짓다	делать; создавать; приготовлять; устанавливать (связь; отношения)
짚다	опираться на что; трогать; предполагать
짜다	Form, organize 관을 ~
짜다	Squeeze, press out 빨래를 ~
쩔쩔매다	To be at a loss, be confused
쫓겨나다	Chase away ; to fire from your job
쫓기다	To be chased, be driven
쫓다	Drive away, chase off
찌다	To put on weight 살이 ~
찌다	chop,hack 떡을 ~
찌르다	stab,thrust
찍다	Stamp with a dojang 서류에 도장을 ~
찍히다	Get sealed, stamped 도장이 ~
찢다	Tear, rend, split
찢어지다	To be torn, rent
차다	ударять ногой; давать пинок 공을 ~
차다	заполняться; наполняться  가득 ~
차다	прицеплять (саблю); прикреплять (орден) 시계를 ~
차리다	Make ready,prepare
참다	Bear, endure
치우다	VST + Do away with, get rid of
찾다	seek,look for
찾아가다	To go to a place to meet somebody
찾아내다	To find out, discover
찾아다니다	To go around to meet somebody or see places
찾아보다	To go meet somebody
찾아오다	To go meet somebody, to go get sth
채우다	наливать (жидкость); наполнять; заполнять 자리를 ~
챙기다	gather,collect, assemble your stuff -- to amass (money, a collection)
쳐다보다	To look up at
추다	To dance 춤을 ~
춤추다	To dance
치다	нападать; атаковать; 얼굴을 ~
치다	(a storm, strong wind, rain, lightning) сильно дуть; хлестать; 폭풍우가 ~
치다	 принимать в расчёт; примерно (приблизительно) подсчитыватьe 셈을 맞추다
치르다	Pay off, pay one’s bill
치우다	Straighten up, tidy, remove
켜다	пилить; играть; зажигать лампу; включать 성냥을 ~
켜지다	To become turned on
키우다	To raise, bring up, rear
타고나다	Be born, gifted/endowed with
타다	Ride (bus) 버스에 ~
태우다	возить; подвозить; подсаживать;  차에 ~
타다	Burn, blaze (firewood) 장작이 ~
태우다	1. сжигать; выжигать; зажигать; воспламенять; терзать 쓰레기를 ~
타오르다	Blaze, light up
타다	Put in, mix, dissolve 물에 ~
타다	Get, receive, take your share of the money (회사에서 월급을 타다) 월급을 ~
태어나다	To be born, see the light of day
터뜨리다	Break, burst,explode
터지다	лопаться; взрываться; раскалываться
털다	стряхивать; вытряхивать; выбивать; смета
튀기다	To fry; splash, splatter 물방울을 ~
튀다	отскакивать; трескаться; лопаться сбежать
튀어나오다	Jump out, spring out
트이다	Get cleared out, open up
틀다	крутить; закручивать; вить; собирать; включать; трепать; перечить; мешать
틀리다	To be turned, warped 2) проваливаться; быть ошибочным (неправильным) 답이 ~
파다	To dig
팔다	To sell
팔리다	To be in demand, to be sold
퍼지다	Spread out, get broader
펴내다	Publish, bring out in print
펴다	Spread out, unfold
펼쳐지다	Stretch, extend away
푸다	Dip out, bail out
풀다	Untie, loosen ; to melt into
풀리다	развязываться; распутываться
풀어지다	To get loose; to turn soft (noodles)
품다	носить за пазухой; обнимать; прижимать к груди; таить в душе что;  가슴에 ~
피다	To bloom ( a flower ~) 꽃이 ~
피우다	разжигать (огонь); топить (печь); поднимать (возню); курить; проявлять (усердие); цвести; издавать; распространять (запах)
해내다	To accomplish, achieve, carry through
헤매다	бродить; шататься; скитаться
헤아리다	Consider, weigh, ponder, consider
헤어지다	расставаться с кем; разлучаться с кем
훔치다	To steal 물건을 ~
흐려지다	Get cloudy, overcast
흐리다	Be muddy, cloudy ;  with a tint of 물을 ~
흔들다	Shake, sway
흔들리다	Shake, swing,rock,tremble
흐르다	Flow, stream
흘러가다	flow,run,drift along
흘러나오다	Flow out, run, effuse
흘러내리다	Run (stream,pour) down
흘리다	spill,shed (tears,blood)
흩어지다	Scatter about
힘들어하다	To be exacting, tolling
힘쓰다	прилагать старания (усилия); стараться
하다	To do
슬퍼하다	sorrow,feel sad
같이하다	вместе делать, разделять
걱정되다	To become worried
걱정하다	To worry or  be anxious
괴로워하다	To distress or  trouble
구경하다	To watch or  enjoy watching
생각되다	To come to think sth
생각하다	To think
자랑하다	To be proud
노래하다	To sing
말씀하다	Speak
못하다	Be impossible
미워하다	Dislike
부러워하다	envy,be envious of
비롯하다	begin,start
사랑하다	To love
수고하다	To work hard
손질하다	Handle with care
싫어하다	To dislike, be reluctant (to do)
얘기하다	To tell a story
이야기하다	To talk
일하다	To work, labor
잘못하다	To make a mistake
잘하다	To do well
좋아하다	To like, be fond of
함께하다	To do it together, with somebody
기뻐하다	радоваться (обрадоваться) кому-чему
마련되다	To be planned and arranged
마련하다	подготавливать; приготавливать; готовить;
그리워하다	Yearn or  be attached to
척하다	притворяться; делать вид; симулировать
체하다	pretend,feign
만하다	такой же, как; величиной с ...
뻔하다	Be clear,evident
아니하다	To be/do not
어떡하다	To take some measures, to manage somehow 어떠하게 하다
가까워지다	Get closer
길어지다	To become long
어두워지다	become/get dark
어려워지다	To become difficult
깨끗해지다	Become clean
나빠지다	To become worse
나아지다	Become better, be improved
낮아지다	Become lower
더러워지다	Get dirty
넓어지다	Get wider
높아지다	Become high
늘어지다	Be lengthened
늦어지다	To become late
굳어지다	Become hard
싶어지다	To come to want
멀어지다	Become distant to
미끄러지다	скользить; поскользнуться; проваливаться
작아지다	Become smaller
적어지다	To become smaller
좋아지다	To become better
짧아지다	To become short
커지다	To become bigger
많아지다	Become a lot
싫어지다	To become distasteful
책임지다	Take responsibility
생각나다	вспоминаться; приходить в голову