정장	正裝; парадная (полная) форма
늦잠꾸러기	соня
벽난로	壁煖爐; печка
껌벅	сверкнуть на миг
분풀이	憤－; ~하다 срывать гнев;
의뢰인	依賴人; клиент (адвоката); доверитель
잔뜩	до отказа; до краёв; полностью; крепко; сильно; очень;
흥분	興奮; волнение; возбуждение; раздражение; ~하다 быть в возбуждении; быть возбуждённым; волноваться; возбуждаться; раздражаться;
헤매다	бродить; шататься; скитаться;
절박	切迫; ~하다 срочный; актуальный; настоятельный; неотложный
사정	事情; обстоятельства; положение дел; обстановка; ситуация; 가정 ~으로 по семейным обстоятельствам; ; 사정 射精; = 토정(吐精)
흥미롭다	Interesting
일지	日誌; ежедневные записи; дневник; ~를 기록하다 вести записи (дневник)
예리	銳利; ~하다 острый; ~한 비판 острая критика
신속하다	迅速; ~히 быстро
멋지다	весьма привлекательный (модный)
서두르다	торопиться; спешить
지켜보다	наблюдать кого; следить за кем-чем
이자	Human, man
협력자	協力; взаимодействие; поддержка; сотрудничество; ~하다 сотрудничать; обьединять усилия; действовать совместно; поддерживать + 자 者; человек;
망설이다	не решаться; колебаться
떨다	дрожать; трястись
시시각각	時時刻刻; ~으로 с часу на час; час от часу; ежечасно и ежеминутно
닥치다	1.наступать; приближаться; 닥치는 대로 без разбора; как попало; 2.нагрянуть; нависнуть (напр.об опасности); 불해이 닥쳤다 Нагрянуло (постигло) несчастье
올리다	поднимать; проводить; устраивать; давать; преподносить; добиваться; вмещать; вписывать; 결혼식을 ~ справлять свадьбу; 기도를 ~ молиться; читать молитву
애처롭다	вызывающий жалость; жалкий
흐트러지다	спутать; запутать; перепутать; смешать;
창백	蒼白; бледность; ~하다 бледный; бескровный; восковой; неяркий; тусклый; ~해지다 бледнеть; тускнеть; меркнуть; ~죽을듯이 ~한 бледный как смерть; 그녀는 나쁜소식을 듣고나서 ~해졌다 Она побледнела, услышав плохую новость.; 그는 병이 난 이후 ~해졌다 Он стал бледным после болезни.; 그녀의 ~함은 그녀가 심한 동요감을 경험했다는 것을 나타내주었다 Её бледность говорила о сильном волнении, которое она испытывала.; 공포감으로 인해 ~해지다 бледнеть от страха (ужаса)
눈동자	－瞳子; зрачок
쫓기다	be pursued[chased] (after); be run[taken] after; be trailed; be hunted (up); be coursed; be hounded.
짐승	животное; (кровожадный) зверь; птица
희다	белый; ясный; чистый; седой
듬성듬성	~하다 редкий; разбросанный
섞이다	быть смешанным (подмешанным; примешанным)
쓰러지다	падать; повалиться; развалиться; слечь; свалиться; потерпеть поражение; пасть; погибнуть; 그는 심한 충격 때문에 쓰러졌다 Он слёг от сильного потрясения.; 기진맥진하여 ~ валиться от усталости; 땅 위에 ~ пасть на землю; 적을 쓰러진다 Неприятель потерпел поражение.; 피로에 지친 말이 쓰러져 죽어 갔다 Изнуренные лошади падали и умирали.; 폭풍에 나무가 쓰러졌다 Дерево свалилось от бури.
힘겹다	непосильный; очень тяжёлый; 힘겹게 с большим трудом
꿰뚫다	пронзать; пронизывать; продырявливать; предвидеть; угадывать; постигать до конца; хорошо знать; быть знатоком
날카롭다	острый; острый; чувствительный; нервный; резкий; 날카로움 острота; тонкость; резкость ; 날카롭게 остро; тонко; нервно; резко; 날카로운 목소리 резкий голос; 날카로운 비판 острая критика; 날카로운 시선 колючий взгляд; 날카로운 창 острое копьё; 끝이 날카로운 메스 остроконечный скальпель
눈초리	взгляд; взор
굽히다	сгибать; гнуть; искривлять; нагибать; уступать; 입 장을 сдавать свой позиции
위로	慰勞; утешение; ~하다 утешать; ~의 말 слова утешения; ~연 банкет (в честь заслуженного человека)
왕복	往復; хождение (движение) (в оба конца); курсирование; поездка в оба конца; ~하다 ходить (ездить; курсировать) туда и обратно; ~ 비행 беспосадочный полёт туда и обратно; челночные полеты; ~ 요금 стоимость проезда в оба конца; проездная плата туда и обратно; ~ 운동 двойное поступательно-возвратное движение; ~ 차표 билет в оба конца
차표	車票; билет на проезд; ~를 예약하다 заказывать билет; ~를 조사하다 проверять билет; ~를 찍다 компостировать; 이 ~는 3일간 유효하다 Этот билет действителен три дня.; 왕복~ билет в оба конца
마차	馬車; телега; запряжка; повозка; 쌍두 ~ парная запряжка
진창	грязь; слякоть; месиво; болото; 오늘은 길이 ~이다 Сегодня слякоть.
튀다	отскакивать; трескаться; лопаться; рассыпаться; разогнувшись, сойти со своего места; сбежать; брызгать; разлетаться; заметно выступать (выделяться)
자국	1. след; ~을 밟다 идти по следу; 2. шрам; ; 자국 自國; своя страна; родина; ~의 родной; отечественный
군데	место; ~~ тут и там; везде; всюду
말라붙다	пересохнуть
또한	(а) также; к тому же
마부	馬夫; кучер; извозчик; конюх
첫차	первый поезд
의지	依支; опора; ~하다 опираться на кого-что; прислоняться к чему; ~할 곳이 없다 негде голову приклонить; ; 의지 意志; воля; стремление; волевой; ; 의지 義肢; искусственная конечность; протез руки или ноги
곤경	困境; трудное (тяжёлое) положение; ~에 빠지다 попадать в переделку; оказываться в тупике (затруднении); быть в трудном (тяжелом) положении
에워싸다	окружать; обступать
암흑	暗黑; мрак; тьма; темнота; 도시가 ~속에 휩싸였다 Город погрузился во тьму.
해주다	делать что кому-чему; производить; совершать; 이것을 내일까지 꼭 해주십시오 Сделайте это обязательно до завтра.
당장	當場; тут же, сразу на месте; ~ 이 자리에서 결판을 내자 Давай всё решим здесь и сейчас.
사례	事例; пример; случай; ~를 설명하다 пояснить примером; 어떤 ~로 들다 привести в пример что-л.; ~를 들다 приводить пример; 그의 ~에 따르다 следовать его примеру; 용기의 ~를 보여주다 показать пример мужества; ~를 보이다 подать пример; ~연구 исследование на примерах; ; 사례 謝禮; благодарность; признательность; ~를 표하다 выражать благодарность; благодарить кого-л. за что-л.; ~를 표하는 благодарный; ~의 표시 знак благодарности; ~ 편지 благодарственное письмо
신뢰	信賴; вера; доверие; ~하다 доверять кому-чему в чем; полагаться на кого; облечь доверием; 나는 그를 ~하지 못한다 Я ему не доверяю.; ~할 만한 사람 надёжный человек; человек, заслужи вающий доверия
서랍	ящик; ~의 ящичный; ~에 집어넣다 укладывать (уложить) в ящик
장식	裝飾; украшение; декорирование; ~적 декоративный; ~하다 украшать; декорировать; разукрашивать; ~되다 украшаться; декорироваться; разукрашиваться; 실내~ внутреннее убранство; оформление интерьера; ~미술 декоративная живопись
기꺼이	с удовольствием; с радостью; 나는 당신을 위해 이것을 하겠습니다 С удовольствием сделаю это для вас.
드리다	1. давать; преподносить; вручать; 선물을 ~ преподносить подарок; 말씀을 ~ говорить; 감사를 ~ приносить кому-чему (свою) благодарность; 보고를 ~ докладывать; 인사를 ~ передавать привет; 2. 마루를 ~ стелить пол; 문을 ~ навешивать дверь
금전	金錢; деньги; ~의 денежный; ~욕 жадность к деньгам; ~ 출납부 кассовая книга
형편	형편 形便; положение; состояние (дел); ~이 펴이다 улучшаться; становиться лучше; ~이 좋으면 при благоприятных обстоятельствах; если обстоятельства сложатся хорошо (позволят); 지금 ~으로는 при этих обстоятельствах; в этой ситуации
지불	지불 支拂; уплата; выплата; платёж; ~하다 выдавать; платить за что; 입장료를 ~하다 платить за вход; 집세를 ~하다 платить за квартиру; 월급을 ~하다 выдавать зарплату; ~서류 платёжный документ; ~수단 платёжные средства; ~신용 платёжный кредит
보람	результат; эффект; польза; толк; 이렇게 풍작을 이룬 것은 열심히 일한 ~이다 Добиться такого богатого урожая результат упорного труда.
대가	대가 代價; вознаграждение; компенсация; плата; цена; 노력의 ~ плата за труд; 어떤 ~를 치르더라도 любой ценой; 헤아릴 수 없는 회생의 ~로 ценой огромных жертв; ~를 치르다платить; расплачиваться; ; 대가 大家; 1.авторитет в чем; корифей; мастер; 러시아 과학의 ~ корифей русской науки; 현대철학의 ~ авторитет в современной философии; ~인 척하다 выдавать себя за авторитет
원인	원인 原因; причина; фактор; ~과 결과 причина и следствие; ~을 밝히다 устанавливать причину; ...의 ~이 되다 становиться причиной чего; 근본~ коренная причина; ; 원인 猿人; неандерталец; обезьяночеловек
막연	막연 漠然ㆍ邈然; ~하다 неопределённый; смутный; туманный
사소하다	사소 些少; ~하다 незначительный; мелкий
약혼자	약혼자 約婚者; помолвленный; жених
증상	증상 症狀; симптом; внешний признак; свидетельство; прогноз; ...할 ~을 보이다 есть признаки того, что ...; указания на то, что ...; подавать сигнал; 발병~을 보이지 않는 환자 пациент, у которого не обнаружены симптомы заболевания; 부차적 ~을 고려한 진단 диагноз с учётом побочных симптомов; 오한 ~이 나다 обнаружить симптомы лихорадки; 위협적인 ~ угрожающие симптомы; 발병의 조기 ~ ранние симптомы заболевания
신경과민	신경과민 神經過敏; нервозность
사악	사악 邪惡; ~하다 зловредный; ~한 사람 зловредный человек; ~한 사상 вредные мысли
물리치다	refuse; turn down; reject. away; beat off; repel; expel;
어쨌든	во всяком случае; так или иначе
의붓아버지	отчим
경계	경계 境界; граница; рубеж; грань; ; 경계 警戒; предостережение; предупреждение; предохранение; охранение; наблюдение; ~하다 предостерегать кого от чего; предупреждать; охранять; ~ 근무 караульная служба; ~ 신호 сигнал тревоги; предупредительный сигнал
유서	유서 遺書; (письменное) завещание; ~를 남기다 оставить завещание (посмертное письмо)
가문	가문 家門; семья; семейство; род; клан
일족	일족 一族; родственники; родня; семья; клан
혈통	혈통 血統; родословие; родословная; происхождение; ~이 좋은 из хорошей семьи
끄덕이다	кивать; покачивать; 가볍게 고개를 ~ слегка кивать головой
손꼽히다	to be considered
부호	富豪 богатый и влиятельный человек
영지	영지 領地; территория; владение
이어지다	быть связанным; 남북 아메리카는 파나마 지형으로 이어져 있다 Северная и Южная Америка связаны Панамским проливом.; 전화가 이어졌다 Звонок прошел. (Телефон соединился.)
세기	세기 世紀; век; столетие; ~적 вековой; столетний
연달다	следовать один за другим
대	代 родословие; родословная; род; поколение; эра; эпоха
걸치다	быть переброшенным (перекинутым) через что; перекидывать; перебрасывать; набрасывать; надевать; накидывать; простираться; тянуться; охватывать; пить; быть на закате; ...에 걸쳐 в течение; в протяжении чего; 걸쳐 놓다 оставлять висеть
몰락	몰락 沒落; падение; гибель; разорение; банкротство; упадок; ~하다 пасть; разориться; обанкротиться; ~한 가문 захудалый род
남다	оставаться; быть вырученным; оставшаяся выручка; 남은 остаточный; оставшийся; лишний, ; 남은 돈 деньги, оставшиеся (после чего); 남은 표 лишний билет; 충분히 남는다 хватит с излишком; более чем достаточно; 남아돌다 оставаться; быть в излишке; быть лишним
지은	짓다 집을 ~ строить дом
낡다	старый; устарелый; ветхий; устаревший; отживший; 낡은 것 старьё; 낡은 관습 старый обычай; 낡은 옷 старое платье; 사진이 빛이 바래 낡았다 Фотография выцвела.
저택	저택 邸宅; особняк; резиденция; (частный) дом
빚쟁이	кредитор; ростовщик
담보	담보 擔保; гарантия; залог; обеспечение; ~하다 гарантировать; давать гарантию; обеспечивать; ручаться за что; ~로 잡히다 отдать что в залог; ~를 요구하다 требовать гарантию; 무한 담보를 하다 гарантировать неприкосновенность границ; 상호 ~ взаимные гарантии
잡히다	находиться в руках; быть выбранным (намеченным); быть сделанным; быть погашенным; быть взятым (захваченным, схваченным); быть обнаруженным (найденным)
외아들	единственный сын
부친	부친 父親; отец; ~께서 건강하신가? Здоров ли отец?
귀족	귀족 貴族; аристократ; аристократия; ~적 аристократический; аристократичный; ~적으로 аристократически; аристократично; ~화되다 превращаться в аристократов; ~계급 аристократия; ~성 аристократичность; ~정치 аристократия; 노동~ рабочая аристократия
비참	비참 悲慘; печаль; горесть; ~하다 печальный; горестный; ~히 горестно; печально; ~한 광경 печальное зрелище; ~한 인생 печальная жизнь
마치다	1. кончать; заканчивать; финишировать; 2. упираться; наталкиваться; покалывать (при движении); 옆구리가 ~ колет в боку
벗다	снимать; сбрасывать; избавляться; освобождаться; отказаться (от обычая); бросить; внешне меняться; 벗은 голый
친척	친척 親戚; близкое родство; ближайшие родственники; родня; ~ 관계 родственные отношения
학업	학업 學業; учёба; учебная работа; учебные занятия; ~을 게을리 하다 не выполнять учебной работы; ~ 성적 успеваемость
의학박사	доктор медицины/врач
학위	학위 學位; учёная степень; научная степень; ~ 논문 научная диссертация; 어문학 박사 ~를 수여하다 присудить (присвоить) учёную степень доктора филологических наук
따다	2. брать; 3. вскрывать, открывать; 요점을 ~ конспектировать; 점수를 ~ набирать очки; получать отметку; 깡통을 ~ открывать консервную банку
환자	환자 患者; пациент; больной; ~명부 список больных
들끓다	сильно кипеть; бить ключом; бурлить; взбудораживаться; возбуждаться; кишеть
곤두세우다	신경을 ∼ pay all one's attention to / be all ears have one's nerves on edge.ㆍ
그만	1.(그만한) мало; так мало, что; не более, чем; только; лишь; 그만 수고를 아끼느냐 Тебе жалко сделать такое маленькое одолжение?; 그만 일에 낙심(하지) 마라 Не расстраивайся из-за такой мелочи.; 그만 일은 삼척동자도 안다 Даже ребенок это знает.; 2.(그 정도까지만) до такой степени; больше не; не более чем; 그만 울어라 Больше не плачь.; 그만 먹어라 Хвать жрать.; 오늘은 그만 하자 Хватит на сегодня.; 자랑 좀 그만해라 Хорош хвастаться.; 3. (곧) как только; не ранее чем; едва; 그것을 보자 그만 기절했다 Она упала в обморок, как только увидела это.; 그 말에 그만 화를 냈다 Эти слова спровоцировали его.
홧김	the influence of anger.  ∼에 under the influence of anger / in a fit of anger[rage / temper / the spleen] / in the heat of passion
집사	집사 執事; исполнитель; управитель; милостивый государь (в письме к вышестоящему); господин; почтённый господин
때리다	1. (치다) бить; избивать; ударять; 얼굴을 ~ бить (ударить) в лицо; 뺨을 ~ дать пощечину; 지팡이로 ~ бить (ударить) палкой; 2. (비난하다) резко критиковать; порицать; осуждать; обвинять; 신문에서 ~ обвинять (кого-либо) в прессе; 그는 어제 나를 때리는 말을 여러 사람에게 하였다 Он публично обвинил меня вчера.
사형	사형 死刑; смертная казнь
처하다	находиться; оказываться; приговаривать; налагать взыскание; взыскивать с кого за что
다행히	быть загнанным (куда); быть гонимым; накапливаться
극형	극형 極刑; высшая мера наказания; смертная казнь; ~에 처하다 казнить; ~에 처해지다 быть казнённым; ~을 선고하다 приговорить к смертной казни
면하다	免－ избегать (чего); избавляться; освобождаться (от чего)
옥살이	옥살이 獄－; пребывание в тюрьме
우울증	меланхолия/депрессия
생기다	появляться; возникать; случаться; происходить; приобретать; находить; выглядеть; 근심이 ~ почувствовать беспокойство; 그 사란은 어디서 돈이 생겼지? Откуда у него деньги берутся?; 그 여자는 어떻게 생겼죠? Какая она из себя? Как она выглядит?; 그는 나이보다 젊게 생겼다 Он выглядел моложе своих лет; 무슨 일이 생겼지? Что с тобой случилось?
주둔	주둔 駐屯; пребывание (войск); базирование; расположение; дислокация; размещение
포병대	артиллерийская часть
소장	소장 少將; генерал-майор; 해군~ контр-адмирал;
쌍둥이	쌍둥이 雙－; близнецы; двойня
친아버지	親－ родной отец
지다	1. падать; вянуть; заходить; исчезать; вымирать; умирать; 꽃이 곧 지겠다 Скоро завянут цветы.; 해가 ~ Заходит солнце.; 해가 질무렵 в сумерках; 얼룩이 지지 않는다 Пятно не исчезает.; 2. затенять; пятнать; пачкать.; 그늘진 거리 тенистая улица.; 3. взваливать что на спину; нести что на спине; быть обязанным; должен кому; нести ответственность.; 무거운 짐을 지고 가다 нести тяжёлый груз на спине.; 나는 그에게 신세를 졌다 Я обязан ему.; 그가 이 일에 책임을 지고 있다 Он несёт ответственность за это.; ; 지다 ; терпеть поражение; проигрывать; уступать; сдаваться; 지기 싫어하는 упорный; непреклонный; 지기 싫어하는 성격 непреклонный характер; 전쟁에서 ~ терпеть поражение на войне (на состязании); 소송에서 ~ проигрывать судебный процесс; 감정에 ~ предаваться чувствам; 유혹에 ~ поддаваться соблазну; 유혹에 지지 않다 не сдаваться (поддаваться) соблазну; 그의 재주는 누구에게도 지지 않는다 Он никому не уступает в таланте; 일본은 한국에게 2대 1로 졌다 Японцы проиграли корейцам со счётом два один.
재혼	재혼 再婚; второй брак; ~하다 вторично вступать в брак
세상	세상 世上; мир; свет; ~없는 не имеющий себе равных; ~없어도 при любых обстоятельствах; ~없이 несравненно; бесподобно; ~에 Боже мой!; ~을 등지다 удаляться от мира; жить затворником; ~을 모르다 совершенно не разбираться в жизни; ~을 모르고 자다 спать как убитый; ~이 바뀌다 коренным образом изменяться; ~을 떠나다 скончаться; уйти из жизни; 나는 결코 자본주의 ~에서 살아본 적이 없었다 Я никогда не жил в капитапистйческсм мире.; ~만사 всё на свете; ~살이 жизнь
떠나다	отправляться; оставлять; покидать; исчезать; пропадать; 길을 ~ отправляться в путь; 현실을 ~ отрываться от действительности
철도사고	train crash
개업	개업 開業; ~하다 открывать предприятие (дело)
중단	중단 中斷; перерыв; промежуток; пауза; интервал; перекур; окно; антракт; ~하다 прекращать; переставать; прерывать; 작업의 ~ перерыв в работе; 자주 ~되는 작업 работа с перебоями; 회의 ~ перерыв в заседании; 전류의 ~ перебой в подаче электрического тока
옮기다	переводить; перемещать; переносить; передавать; пересказывать; передавать (услышанное)
수입	수입 收入; доход; приход; поступления; ~의 доходный; приходный; ~하다 получать доход; приходовать; 당신의 개인 ~은 얼마나 되는가? А каковы ваши личные доходы?; ; 수입 輸入; импорт; ввоз; ~하다 импортировать; ввозить
유언	유언 遺言; завещание; воля; предсмертная воля; желание; последние слова ; ~하다 завещать; ~에 따라 согласно воле; ~ 남기지 않고 죽다 умереть; не оставив завещания
재산	재산 財産; имущество; состояние; 국유~ государственное имущество; 사유~ частное (личное) имущество; 지적 ~ интеллектуальная собственность; ~목록 опись имущества; ~몰수 конфискация имущества
양도	양도 讓渡; уступка; передача; ~하다 передавать; уступать; ~할 수 있는 допускающий передачу; 소유권을 ~하다 передавать имущественные права
자매	자매 姉妹; сестры; ~도시 города-побратимы
한하다	한하다 限－; ограничиваться; 짧은 이야기로 ~ ограничиваться временем при выступлении; 어떤 사람의 권리를 ~ ограничивать кого в правах
경우	경우 境遇; обстоятельства; ситуация; случай; пример; возможность; шанс; отдельный пример; 이 ~ в этом случае; 그런 ~ в таком случае; 모든 ~에 во всех случаях; ...한 ~에는 в случае; в случае чего; если...; 보통의 ~면 при обычных обстоятельствах; 대개의 ~에는 в большинстве случаев; 필요한 ~ в случае нужды; ~에 따라서 в соответствии с ситуацией, согласно обстоятельствам; в зависимости от обстоятельств; 내 ~에는 в моем случае
일정하다	일정 一定; ~하다 определённый; установленный; регулярный; определять; устанавливать; 일정 日程; программа; расписание; повестка дня
액수	액수 額數; сумма (денег)
유산	유산 遺産; наследие; наследство; ~ 상속인 наследник; 문화 ~ культурное наследие
덕분	덕분 德分; милость; ~에 благодаря кому-л.
넉넉하다	достаточный; обильный; быть с запасом; зажиточный; 넉넉히 достаточно; с запасом; с излишком; 넉넉한 살림 обеспеченная жизнь; 돈이 넉넉하다 иметь много (достаточно) денег; 시간이 넉넉하다 иметь достаточно (много) времени
방해	방해 妨害; препятствие; помеха; преграда; ~하다 мешать (кому-чему); препятствовать; тормозить; чинить препятствия; ~가 되다 быть помехой (препятствием); ~되지 않습니까? Не помешаю вам?; 라디오가 공부하는 데 ~가 되었다 Радио мешало мне заниматься
난폭	난폭 亂暴; насилие; грубость; ~하다 буйный; грубый; ~한 행실 буйное поведение; ~하게 굴다 буйствовать; грубить
사귀다	общаться; дружить; водить знакомство с кем-либо; пересекаться; скрещиваться; 사귀기 어려운 여자 женщина, с которой трудно общаться; 사귀기 좋은 사람 дружелюбный (общительный) человек; 얼마나 사귀다 결혼했어요? Сколько вы были знакомы перед тем как поженились?
끼리	между собой; вместе; ~~ друг с другом
틀어박	hoard; keep in dead storage;
그러다가	then
이따금	то и дело; часто; время от времени
붙들다	ухватить; ухватиться; браться (за дело и т. п.); помогать; поддерживать; 달아나는 도둑을 ~ ловить убегающего вора; 손님을 ~ принимать гостей
벌이다	раскладывать; расставлять; распростирать; начинать; основывать; открывать
본래	본래 本來; с (самого) начала; изначально; искони; вообще; по природе; по существу; по сути дела
광적	狂的 ~이다 сумасшедший; безумный; неистовый
격렬	격렬 激烈; ~하다 ожесточённый; бурный; буйный; пламенный; ~한 논쟁 ожесточённый спор
열대지방	
더욱	ещё более; ~좋아지다 становиться лучше; улучшаться; ~큰 소리로 말하다 говорить еще громче
거치다	заходить за что; заезжать за что; преодолевать; задевать; спотыкаться; 거쳐서 через что
끌리다	1. тянуть; тащить; 범인이 현장에서 붙들려 경찰서로 끌려갔다 Преступник был поймат с поличным и отправлен в полицию.; 2. тащиться; волочиться; 치마가 끌리다 Ее платье волочилось по полу.
생기	생기 生氣; живость; бодрость; жизненность; ~가 엾는 безжизненный; ~가 있는 оживлённый; живой; полный жизни
해도	해도 海島; морской остров; ; 해도 海濤; морские волны
슬슬	незаметно; слегка; не спеша; втихомолку; украдкой; ~ 걸어가다 брести; ~ 다가가다 подходить украдкой; 눈이 ~ 녹고 있다 Незаметно тает снег.; ~ 어루만지다 слегка поглаживать
피하다	избегать; уклоняться; избавляться; укрываться; прятаться
세다	1. сильный; 당신은 손 힘이 세니, 이 덮개를 뽑아주시요 У вас сильные руки, отвинтите эту крышку.; 센 바람이 일었다 Поднялся сильный ветер.; 2. жёсткий; грубый; твёрдый; 뻣뻣하고 센 머리털 жёсткие волосы; ; 세다 ; седеть; бледнеть; сереть; 그는 머리가 셌다 Он поседел.; ; 세다 ; считать; сосчитать; 돈을 ~ считать деньги; 백가지 ~ считать до ста; 손가락을 곱아 ~ Считать на пальцах.; 권투선수는 아홉까지 카운터를 세었을 때에야 일어났다 Когда сосчитали до девяти, боксёр поднялся.
절대로	절대로 絶對－; абсолютно; категорически; безусловно
참다	терпеть; переносить; удерживаться; сдерживаться; держать себя в руках; 고통을 ~ терпеть страдания; 굴욕을 ~ переносить унижение; 열기를 ~ переносйть жар; 모욕을 ~ переносить оскорбление; 졸음을 ~ терпеть сонливость; 치통을 ~ переносить зубную боль; 참을 수 없는 невыносимый; не в силах терпеть; 아파서 도저히 참을 수 없다 Не в состоянии терпеть боль.; 나는 도무지 웃음을 참을 수가 없다 Я не могу удержаться от смеха.
대장간	대장간 －間; кузница
강물	강물 江－; речная вода; река
던지다	бросать; выбрасывать; забрасывать; кидать; метать; 공을 ~ бросать мяч; 담배꽁초를 휴지통에 ~ бросить окурок в урну; 시선을 ~ кидать взоры на кого-что; 아무데나 마구 ~ бросать куда попало; 피문을 ~ вызвать сенсацию
행패	행패 行悖; бесцеремонность поведения; произвол; ~하다 бесцеремонно вести себя; творить произвол
부리다	заставлять работать; водить (напр, машину); править (напр, лошадью); проявлять (какие-л. качества)
동네	동네 洞－; селение; деревня; 한 ~ 사람 односельчан; ~ 방네 вся деревня
털다	стряхивать; вытряхивать; выбивать; сметать; обворовать; обчистить; 옷의 먼지를 ~ стряхивать с одежды пыль; 지붕에서 눈을 털어내다 сметать снег с крыши; 도둑이 빈 집을 ~ вор обворовывает пустой дом
겨우	едва; еле; с трудом; ~~ едва-едва; ~ 두 사람 남았다 Осталось лишь два человека.; ~ 살아가다 перебиваться; ~ 열차 시간에 댔다 Едва успел на поезд.
떠돌이	a vagabond; a drifter;
가시덤불	a thorny thicket[shrub
무성	무성 無聲; беззвучный; немой; безголосый; ; 무성 茂盛; ~하다 густой; становиться густым; густо расти; 언덕에는 풀이 ~하였다 На холмах росла густая трава
천막	천막 天幕; палатка; шатёр; ~을 치다 разбйть палатку
치다	1. играть (в мяч; в карты); нападать; атаковать; вилять (хвостом); валить; мести; сильно дуть; хлестать; биться; хлопать в ладоши; шалить; посылать телеграмму; вить (верёвку); громко крикнуть; печатать; бежать; спасаться бегством; 2. опускать (штору); закидывать (сети); ставить (ширму); натягивать (сетку от комаров); возводить (стену); ставить перегородку (ограду); плести (паутину); 3. чистить; очищать; вытирать; подтирать; 4. приносить (потомство); пускать (корни); держать (скот; птицу); держать (квартирантов); 5. подвергаться; испытывать; 시험을 ~ сдавать экзамен; 6. принимать в расчёт; примерно (приблизительно) подсчитывать
허락	허락 許諾; разрешение; согласие; ~하다 разрешать; давать согласие на что; одобрять; 누구의 ~을 받고 당신은 이 방에 들어왔습니까? Кто вам позволил войти в эту комнату?
보답	보답 報答; ответ (на заботу; внимание); ~하다 отвечать (на заботу; внимание); воздать десятерицею; ...의 ~으로 в ответ (на что-л.)
대접	миска; 국을 담은 ~ миска с супом; ; 대접 待接; 1. угощение; ~손님에게 과일을 ~하다 угощать гостей фруктами; 2. приём; обращение; ~하다 угощать кого чем; принимать; обращаться с кем; 정성스런 ~ сердечный прием; 저녁 ~을 받다 быть приглашенным на ужин
한패	one of the (same) party; an accomplice
게다가	к тому же; вдобавок; более того; сверх того
현지인	местный житель; абориген
통하다	через; посредством кого-чего
들이다	1. заставлять (позволять) входить; впускать; принимать; 2. красить; окрашивать; 빨간물을 ~ окрашивать в ярко-красный цвет; 3. вселять; поселять; 친척을 자기집에 ~ поселить у себя родственников; 4. давать; предоставлять; 돈을 ~ ассигновать средства
표범	표범 豹－; леопард; леопардовый
묶이다	быть связанным (перевязанным)
두려워하다	бояться; страшиться; испытывать боязнь (страх); опасаться; трусить; робеть перед кем
결코	결코 決－; ни в коем случае; абсолютно; совершенно; никак не; отнюдь
하녀	하녀 下女; служанка; горничная; прислуга; ~로 일하다 служить (работать) горничной (прислугой)
안일	домашняя работа; работа по дому; ; 안일 安逸; беззаботность; праздность; беспечность; ~하다 беззаботный; праздный; беспечный; ~한 젊은이 беззаботный юноша
짐작	짐작 斟酌; догадка; ~하다 догадываться; предполагать; ~하건대 вероятно
유별	유별 有別; особенный; необычный; отличный; различный; ~난 사람 необычный человек; ; 유별 類別; классификация; сортировка; ~하다 классифицировать; сортировать
또래	ровесники; одногодки
신분	신분 身分; общественное (социальное) положение; профессии; личность; индивидуум; лицо; сословие; ~적 сословный; ~을 밝히다 установить личность кого; ~을 속이다 скрывать свою сущность; скрывать своё лицо; 농노 ~ крепостное сословие
접촉	접촉 接觸; соприкосновение; контакт; ~하다 соприкасаться; контактировать; быть в контакте; ~을 가지다 устанавливать (поддерживать) контакт с кем
이모	이모 姨母; тётя (сестра матери)
머물다	stay at
대기	대기 待機; ожидание; выжидание; простой; ~하다 ожидать; выжидать
해병대	해병대 海兵隊; морская пехота
소령	소령 少領; майор; командующий
남기다	оставлять; извлекать выгоду ; 남김없이 без остатка; всё целиком; 메모를 ~ оставлять записку; 재산을 ~ оставлять имущество; 흔적을 ~ оставлять след; 장사에서 남긴 돈 выручка; вырученные деньги
기대다	1. опираться; прислоняться; покоиться; 기대어 앉다 сесть, прислонившись к чему; 지팡이에 ~ опираться на трость; 책상에 ~ прислоняться к столу; 2. надеяться на; быть уверенным; полагаться; рассчитывать на кого-либо; зависеть от кого-либо
가늘다	1. тонкий; стройный; грациозный; узкий; тесный; 가는 목 тонкая шея; 눈을 가늘게 뜨고 보다 прищуриться; 가늘어지다 утончаться; 2. тонкий; мелкий; высококачественный; хороший; 3. слабый; слабовольный; щуплый
흘낏	keep sharply[angrily]
정확하다	정확 正確; ~하다 правильный; точный
휘파람	свист; ~을 불다 свистеть
잠귀	~가 어둡다 крепкий (о сне); ~가 밝다 чуткий (о сне)
깨다	1. пробуждаться; проснуться; очнуться; прийти в себя; протрезвляться; 2. постигнуть; понять; быть просвещённым; 잠에서~ пробудиться ото сна; ; 깨다 ; 1. разбивать; ломать;; 2. наносить рану; ранить; 3. нарушать; подрывать; ~낡은 관습을 ломать старые обычаи; 정적을~ нарушить тишину
질색	窒塞  испытывать отвращение; неприятно поражаться;
잔디밭	лужайка; газон; ~에서 바늘 찾기 искать иголку в стоге сена
불다	дуть; раздувать; играть (на духовом инструменте); свистеть; выдавать (секрет); 바람이 ~ дует ветер; 손을 호호 ~ дуть на руки; 휘파람을 ~ свистеть; 피리를 ~ играть на свирели
정원	정원 庭園; двор и цветник
잠들다	1. заснуть; 2. умереть
채우다	1. запирать (на замок); застёгивать (на пуговицы); закрывать; 문을 ~ запирать дверь; 단추를 ~ застёгивать на пуговицы; 2. наливать (жидкость); наполнять; заполнять; 3. завершать (к условленному сроку); удовлетворять чьи желания; 욕망을 ~ утолить желание; 4. отбывать наказание; отсиживать срок
잠그다	запирать; закрывать; погружать; опускать; окунать
물다	держать (во рту, в клюве); кусаться; хватать; 담배를 ~ держать сигарету во рту; ; 물다 ; платить; возмещать; 얼마나 물어야 합니까? Сколько с нас?
기르다	выращивать; выхаживать; откармливать; воспитывать; выпестовать; воспитывать; прививать; отращивать; запустить; 아이들을 ~ выращивать детей; 우수한 전문가를 ~ воспитывать способных специалистов; 음악에 대한 취미를 ~ прививать вкус к музыке
놓이다	быть отпущенным; быть освобождённым; успокаиваться; находиться; лежать (на чём); быть установленным; быть сооружённым; 기숙사 입구에 전화가 놓였다 У входа общежития установлен телефон.; 나는 지금 곤란한 처지에 놓여 있다 Сейчас я нахожусь в затруднительном положении.
그러하다	такой; 그러한 경우엔 в таком случае
영혼	영혼 靈魂; душа; дух; ~ 불멸 бессмертие души
미묘	미묘 微妙; ~하다 тонкий; утончённый; деликатный; 미묘한 문제 деликатный вопрос; ; 미묘 美妙; ~하다 1. красивый; изысканный; элегантный; 2. мелодичный
반응	반응 反應; реагирование; реакция; эффект; воздействие; ~하다 среагировать; вступать в реакцию
폭풍	폭풍 暴風; буря; шторм; ураган; ~의 (~ 같은) бурный; штормовой; ураганный; ~이 일다 штормить; ~ 때문에 우리는 밤새 눈을 붙이지 못했다 Из-за бури мы всю ночь не сомкнули глаз.; 찻잔 속의 ~ буря в стакане воды; ~ 경보를 내리다 предупреждать о буре
폭풍우	폭풍우 暴風雨; буря и ливень
심하다	심하다 甚－; сильный; резкий; жестокий; 심한 모욕 жестокая обида; 심한 추위 крепкий мороз; 심한 코감기 сильный насморк; 심한 폭우 сильный ливень
몰다	гнать; сгонять; загонять; отгонять; отпугивать; управлять; водить; преследовать; направлять; поворачивать; ругать; поносить; ...로 ~ считать (рассматривать; обращаться) как ...; 죄인으로 ~ считать преступником
빗줄기	струи дождя
두드리다	стучать; бить; колотить; 문을 ~ стучать в дверь; 주먹으로 ~ бить кулаком
틈새	трещина; щель; узкое место; 추위 때문에 돌에 ~가 생기다 камень трескается от холода
비명	비명 非命; вопль; крик; ~지르다 вопить; кричать
두르다	окружать; огибать; обходить по краю; окутывать; обматывать; обвязывать; надевать; 목도리를 목에 ~ обвязать шею шарфом; 머리에 수건을 ~ повязать голову платком
뛰어나가다	выбегать; выскакивать; неожиданно (внезапно) появиться
이어서	continuously; successively; subsequently; soon after.
금속	금속 金屬; металл; ~의 металлический; ~이 함유된 металлоносный; ~ 가공업 Металлообрабатывающая промышленность; ~ 건자재 металлические строительные материалы; ~결정 кристалл металлов; ~공업 металлургическая промышленность; ~공학 металлургия; ~관 металлическая труба; ~물리학 металлофизика; ~산화물 окись металла; ~ 전자관 металлическая радиолампа; ~ 절삭공구 металлорежущий инструмент (прибор); ~피복 металлическое покрытие; ~활자 металлический подвижный шрифт
두려움	страх; боязнь
램프	램프 англ. lamp; лампа; фонарь; светилник
공포	공포 公布; обнародование; официальное объявление; опубликование; ~하다 обнародовать; официально объявлять; опубликовывать; ; 공포 恐怖; страх; боязнь; ~ 정치 политика запугивания; ; 공포 空砲; холостой выстрел; ~ 사격 холостой выстрел; = 헛총
구조	구조 救助; спасение; помощь; выручка; ~하다 спасать; помогать кому в чём; выручать кого что; оказывать помощь кому в чём; 인명을 ~하다 спасать кому жизнь; ~ 신호 сигнал бедствия; сигнал SOS; ~ 작업 спасательные работы; ; 구조 構造; конструкция; структура; устройство; строй; ~의 конструктивный; ~ 조정 регулирование структуры
청하다	請－ просить; звать; приглашать
마치	точно; словно; как будто; ~ 꾀꼬리처럼 노래하다 петь, словно соловей
비틀거리다	идти пошатываясь
달려가다	бежать; 그느 급히 옷을 입고 병원으로 달려갔다 Он торопливо оделся и побежал в больницу.
주저앉다	плюхаться; тяжело садиться; опускаться; оседать; рушиться; разрушаться; обваливаться; проваливаться; 피곤한 모습으로 소파에 ~ устало опускаться на диван; 집이 ~ рушится дом; 다리가 주저앉았다 Мост обвалился.
고통	고통 苦痛; боль; мука; страдание; ~스럽다 мучительный; ~을 주다 мучить
몸부림	~ 치다 метаться; барахтаться; корчиться; ворочаться во сне
경련	경련 痙攣; судорога; конвульсия; подёргивание; спазм; ~이 일다(~하다) сводить что судорогой; подёргиваться; 심장~ сердечные спазмы; 피부~ спазмодермия
일으키다	поднимать; возбуждать; вызывать; 공포심을 ~ вызвать страх; 호기심을 ~ возбудить любопытство; 먼지를 ~ поднимать пыль
알아보다	распознавать; узнавать; расспрашивать
정신	정신 精神; дух; душа; ~의 душевный; духовный; умственный; ~분석 психоанализ; ~상태 психика; моральное состояние; ~위생 психогигиена; ~이상 душевное (психическое) расстройство
흘리다	лить; проливать; выливать; просыпать; рассыпать; ронять; терять; лишаться чего; разделять (распределять) по-немногу (частями); писать неразборчиво (скорописью); делать едва заметные штрихи; прослушать; пропустить мимо ушей; пускать по течению; сплавлять; выболтать; выдавать; открывать; извещать кого о чём
되찾다	снова искать (разыскивать)
기력	기력 汽力; = 기운
멈추다	прекращать(ся); переставать; останавливать(ся) ; 눈길를 ~ остановить взгляд на чём
가엾다	жалкий; несчастный; бедненький; ничтожный; 가엾게 여기다 жалеть; сжалиться (над кем-л.); 가엾은 고아 несчастный сирота; 가엾기도 하다 какая жалость!
끔찍하다	поразительный; удивительный; ужасный; чрезмерный; чрезвычайный; ужасный; ужасающий; вызывающий содрогание; 끔찍하게, 끔찍히 поразительно; удивительно; чрезмерно; ужасно; 끔찍한 광경 ужасающее зрелище; 엄마는 끔찍하게 제 자식을 사랑한다 Мама ужасно любит своего ребёнка.
착각	착각 錯覺; ошибочное (превратное) представление; иллюзия; заблуждение; несбыточная мечта; галлюцинация; обман чувств; ~하다 заблуждаться; создавать себе (строить) иллюзии; создавать ложное впечатление; питать иллюзии; 도둑으로 ~하다 принимать кого за вора; 그녀의 ~은 산산조각 났다 Её иллюзии рассеялись.; ; 착각 錯角; противоположный угол
잠옷	ночная рубашка; пижама
바라다	надеяться; желать; хотеть; 건강을 바랍니다 Желаю вам здоровья.
성냥	спички; ~갑 коробка спичек; ~개비 (одна) спичка
성냥갑	성냥갑 -匣; спичечный коробок
낌새	признак; симптом; намёк; ~를 채다 догадаться
살펴보다	рассматривать; разглядывать; 지도를 ~ рассматривать карту
결론	결론 結論; вывод; заключение; заключительное слово; ~(을) 짓다 делать вывод; выступать с заключительным словом; ~이 나다 заключаться; заканчиваться
포악	포악 暴惡; ~하다 жестокий; безжалостный; злой; ~무도하다 крайне жестокий
인근	인근 隣近; сосед, соседство
널리	широко; просторно; великодушно; снисходительно; благосклонно; 그의 명성은 소장학자들에게 ~ 알려져 있다 Его имя распространено (широко известно) среди молодых учёных; 저희를 ~ 용서해주세요 Простите нас великодушно.
끝내	в конце концов; наконец
사인	사인 sign; подпись; ~하다 подписываться; расписываться; ; 사인 死人; мертвец; умерший; ; 사인 死因; причина смерти
밝혀내다	
굵다	толстый; крупный; большой; басистый; громкий; мощный; грубый
막대	
구식	구식 舊式; старый тип; старая мода; ~의 старого типа; старомодный; устаревший
문단속	문단속 門團束; ~하다 закрывать двери на замок
구석구석	каждый угол; в каждом углу; ~ 찾다 искать по всем углам
편이	편이 便易; ~하다 удобный; легкий
상처	상처 傷處; рана; ~를 입다 быть раненым; пораниться; ~난 곳에서 피가 흐르고 있다 Из раны идёт кровь.; ~를 치료하다 залечивать рану; ~가 아물었다 Рана залечилась.
독살	독살 毒殺; убийство при помощи яда; отравление; ~하다 отравлять; ~당하다 быть отравленным; ; 독살 毒煞; злоба; ~스럽다 злобный; ядовитый; язвительный; ехидный; ~스레 со злобой; язвительно; ехидно; ~을 부리다 злиться; ехидничать
감당	감당 堪當; ~하다 выдержать; справиться; вынести; брать на себя; ~할 수 없다, ~하지 못하다 не справляться (с чем-л.)
쇼크	쇼크 англ. shock; шок; побуждение; импульс; толчок; удар; скирда; ~를 주다 дать толчок; 그의 사망은 우리에게 큰 ~였다 Его смерть была для нас тяжёлым ударом.; 이 전구를 만지지 마라, 그러지 않으면 당신은 전기 ~를 받게 될 것이다 Не трогай эти лампочки, а то тебя ударит током
그리다	1. = 그리워하다; 2. рисовать; писать красками; чертить; изображать; описывать; воображать; представлять себе; рисовать в воображении; 지도를 ~ чертить географическую карту; 그녀는 간혹 마음속으로 자신을 미인이라고 그려 보곤 한다 Иногда она в мыслях воображает себя красавицей.
당시	당시 當時; тогда; в то время; ~의 тогдашний; 전쟁 ~에 во время войны
곧잘	довольно хорошо; прилично
물방울	водяная капля
착란	착란 錯亂; отвлечение; раздор; путаница; ~의 путаный; беспорядочный; нелогичный; бессвязный; ~하다 быть растерянным; сбиваться с толку; ~상태 состояние слабоумия; 정신~ слабоумие
헛소리	болтовня; вздор; чепуха; бессмыслица; нелепость; бред; ~하다 бредить; нести (говорить; молоть) вздор; врать
담기다	быть положенным во что (на что); быть вложенным; быть наполненным (налитым; набитым); 끓는 물이 다긴 컵 стакан, наполненный кипятком; 정성이 가득 담긴선믈 подарок от всего сердца
청혼	청혼 請婚; предложение; ~하다 делать предложение; просить руки
구멍	отверстие; дыра; щель; нора; яма; отдушина
오지	오지 奧地; глухое место в горах; медвежий угол; глубь страны; глубинные районы (пункты)
정적	정적 政敵; политический противник; ; 정적 靜寂; тишина; уединение; ~하다 тихий; уединённый; ~을 깨트리다 нарушать тишину
예고	예고 豫告; предупреждение о чём; предуведомление; ~하다 предупреждать кого о чём; предварительно уведомлять о ком-чём (извещать кого о чём); предуведомлять о ком-чём; 위험을 ~하다 предупреждать об опасности; ~없이 без предупреждения (предуведомления)
벌떡	внезапно; ~ 일어나다 внезапно вставать
도무지	совсем; совершенно; вовсе
몰래	незаметно; украдкой; тайком; потихоньку; ~~ совершенно незаметно (тайно)
감싸다	1. обертывать; завертывать; 2. покрывать; брать под защиту; 죄인을 ~ покрывать преступника
얹다	класть на что; наложить; набавлять; прибавлять
엄지	большой палец; ~발가락 большой палец (на ноге); ~발톱 ноготь большого пальца (на ноге); ~손가락 большой палец (на руке)
반점	반점 斑點; пятно; крапинка; запятая; ~을 찍다 ставить запятую
선명하다	선명 鮮明; ~하다 ясный; отчётливый; чёткий
드러나다	показываться; обнаруживаться; выявляться; приобретать широкую известность
손찌검	рукоприкладство; ~하다 бить рукой
당하다	당하다 當－; сталкиваться с чем; попадать; оказываться; подвергаться; испытывать; терпеть; встречать; преодолевать; побеждать; выносить; выдерживать; справляться с чем; снабжать; поддерживать; соответствующий; подходящий; уместный; 검거를 ~ быть арестованным; 모욕을 ~ терпеть оскорбление; 불행을 ~ попасть в беду; 어려움을 ~ сталкиваться с трудностями; 그는 이 일을 당해 낼 수 없다 Он не в силах справиться с этой работой.; 이 세상에 우리를 당할 수 있는 자는 없다 Нет в мире такой силы, которая могла бы победить нас.
붉다	красный; 붉은 광장 Красная площадь
얼른	быстро; живо
감추다	прятать; скрывать; утаивать; 몸을 ~ прятаться; 자취를 ~ скрываться; исчезать из виду; 나이를 ~ скрывать свой возраст; 감추지 않고 не скрываясь
침묵	침묵 沈默; молчание; тишина; ~하다 молчать; ~을 깨다 (지키다) прервать (хранить) молчание; ~이 깃들다 затянулось (воцарилось) молчание
턱	1. челюсть; подбородок; ~을 악물다 сжимать (стискивать) челюсти; 위~ верхняя челюсть; 아래~ нижняя челюсть; 2. порог; небольшой выступ; ~이 지다 иметь выступ; немного выступать; 3. угощение по случаю какого события; 한 ~내다 угощать по случаю радостного события; 4. основание; мотив; повод; причина; 이런 일을 할 ~ 있나 Нет причины делать это.; 5. вдруг, неожиданно; совсем; сильно; крепко; невозмутимо; ~ 멎다 вдруг остановиться; ~ 쓰러지다 неожиданно упасть; 마음을 ~ 놓다 успокоиться; 숨이 ~ 막혔다 Сильно захватило дух.; ~ 잡다 крепко взять; 문앞에 ~ 버티고 서다 невозмутимо встать в дверях
괴다	턱을 ~ подпирать рукой подбородок
파헤치다	разгребать; копаться; раскидывать; взрывать; разрывать; раскрывать; 닭이 두엄을 ~ курица копается в навозе; 비밀(음모)을 ~ открывать тайну (заговор)
지체	происхождение; род; ~가 높다 высокое происхождение; ; 지체 肢體; конечности; ~가 부자유한 хромой; повреждённый; ~장애인 инвалид; калека; ; 지체 遲滯; задержка; приостановка; откладывание; отсрочка; ~하다 задерживать; отсрочивать; откладывать; ~없이 сразу же; незамедлительно
가정부	가정부 家政婦; домохозяйка
미련	глупость; тупость; ~스럽다 казаться глупым (тупым); ~하다 недогадливый; глупый; тупой; ~을 남기다 оставить рану в сердце; поселить в душе тоску; ; 미련 未練; неотвязная мысль; сожаление; ~을 가지다 быть (всё ещё) привязанным к кому-либо; тосковать по кому-либо
갈다	1. заменять; менять; 이름을 ~ поменять имя; 갈아 입다 переодеваться; 갈아타다 пересаживаться; делать пересадку; 2. точить; заострять; молоть; перетирать; править (бритву); 칼(날)을 ~ точить нож; 이를 ~ скрежетать зубами; 3. возделывать землю; пахать; 밭을 ~ вспахать поле
모처럼	нарочно; специально; впервые (за долгое время)
만날	изо дня в день; постоянно; всегда
으스스	~하다 чувствовать озноб; вызывать (испытывать) нервную дрожь
이지	이지 理智; интеллект; разум; ~적인 интеллектуальный; разумный; ~적인 사람 разумный человек
더구나	вдобавок; кроме того; сверх того; к тому же; 말을 함부로 하는데다 ~ 거짓말까지도 한다 Грубит, да в добавок еще и лжет
살해	살해 殺害; убийство; ~ 사건 убийство
불가사의	불가사의 不可思議; непостижимый; ~한 자연의 신비 непостижимое таинство природы; ~한 사건 необъяснимое происшествие
단서	단서 但書; исходный пункт; ключ; начало; путеводная нить; ~가 되다 служить поводом; ~를 잡다 найти ключ к чему
역할	역할 役割; роль; ~을 할당하다 отводить роль; ~하다 играть роль; исполнять долг (роль); 중대한 ~을 하다 играть важную роль (в чём)
각반	각반 脚絆; гетры; краги; обмотки для ног; ~을 치다 надевать гетры; наматывать обмотки
사냥	охота; ~하다 охотиться; 맹수 ~하다 охотиться на хищника; 여우를 ~하다 охотиться на лис; 매~ соколиная охота; 비둘기~ голубиная охота
채찍	кнут; бич; плётка
문틀	문틀 門-; дверная рама
닿다	соприкасаться с чем; прикасаться; доставать чего (до чего); добираться до чего; доноситься до чего; достигать чего (до чего); устанавливаться; 목적지에 ~ добираться до назначенного места; 손이 책상에 ~ прикоснуться рукой к столу; 기차가 정시에 닿았다 Поезд прибыл точно в установленное время.; 그는 힘이 닿는 데까지 달렸다 Он бежал что есть силы.; 전쟁 소식이 우리 마을에까지 닿았다 Весть о войне дошла до нашего села.
볕	солнечный свет; лучи солнца; светит солнце; ~에 앉아 꾸벅꾸벅 졸고 있는 고양이의 모습이 한가 롭다 Вид кошки, сидящей и дремлющей на солнце, непринужден.
주름살	морщина (на лице); складка
노기	노기 怒氣; гнев; ~가 어리다 гневный; ~를 띠고 с гневом; ~ 어린 얼굴 гневное лицо; ~등등하다 быть разгневанным (разъярённым); ~를띠다 быть в гневе
움푹	~하다 очень впалый; сильно вогнутый (посередине)
비록	хотя; ~ 농담이라 해도 хотя это и шутка ...
독수리	an eagle; a vulture.
떠올리다	всплывать (в памяти)
번갈아	alternately; by turns; in turn
미행	미행 尾行; слежка; ~하다 ходить по пятам; следить за кем-либо; ~자 сыщик
대체	대체 代替; замена; замещение; ~하다 заменять; поставлять что взамен чего; ; 대체 大體; главное; основное; суть; ~ 무었이 문제니? В чем же дело?
태연	태연 泰然; ~하다 спокойный; хладнокровный; невозмутимый
표정	표정 表情; выражение лица; чувство, выраженное на лице; мимика; ~이 풍부한 얼굴 выразительное лицо; 얼굴에 쓴 ~을 짓다 корчить рожу (гримасу; мину)
소리치다	cry; yell; shout; holler; bawl
여전하다	여전 如前; ~하다 как прежний
침착하다	침착 沈着; хладнокровие; самообладание; невозмутимость
어물쩍	~하다 уклоняться; хитрый
속셈	подсчёты в уме; ~하다 считать (подсчитывать) в уме; прикидывать (рассчитывать) в уме; 나는 비용을 ~해보고 흠칫 놀랐다 Я подсчитал в уме расходы и пришел в ужас!; ~이 뭐냐? Что ты подсчитываешь в уме?
설치	설치 設置; ~하다 устанавливать; монтировать; создавать; учреждать; основывать; ~대 станина; ~안 план; проект
참견	참견 參見; вмешательство; ~하다 вмешиваться; соваться; принимать личное участие; 남의 일에 ~하다 соваться (вмешиваться) в чужие дела; 외부에 ~없이 без вмешательства извне; 외부의 ~ постороннее вмешательство; 무의미한 ~ бессмысленное вмешательство; 이것은 네가 ~할 일이 안이다 Это не твоё дело.
잘하다	делать (исполнять; вести) хорошо (искусно; умело); успешно осуществлять
앞잡이	прислужник; приспешник; агент
유쾌	유쾌 愉快; ~하다 приятный; весёлый; ~하게 시간을 보내다 весело проводить время
문틈	문틈 門-; щель (щёлка) в двери
구부리다	bend
괜히	сокр. от 공연히 - напрасно, зря
성큼성큼	~걷다 ходить подпрыгивающей походкой
꽤	довольно, в известной степени, достаточно, в значительной степени, вполне
등기	등기 等記; 1. регистрация; 2. заказное почтовое отправление; ~우편 заказное почтовое отправление
투자	투자 投資; инвестиция; капиталовложение; ~하다 вкладывать (капитал); инвестировать
평가	평가 平價; нормальная (умеренная) цена; стабильная цена; ~ 절상 ревальвация; ~ 절하 девальвация; ; 평가 評價; оценка; ~하다 оценивать; 그는 좋은 ~를 받고 있다 Он пользуется хорошей репутацией.; 외모로 사람을 ~해서는 안된다 Не следует судить о человеке по его внешности.
연간	연간 年刊; в течение года; за год; ~ 10%씩 на десять процентов в год; ежегодно на десять процентов
하락	하락 下落; падение; снижение; ~하다 падать; снижаться; понижаться; 물가의 급격한 ~ резкое снижение цен; 주가가 ~한다 цена акций понижается
권리	권리 權利; право; ~가 있다 быть в праве; ~를 갖다 иметь право на что; ~ 를 되살려주다 восстановить кого в правах; ~를 박탈하다 лишать кого какого-либо права; ~ 를 부여하다 предоставлять кому право; ~를 축소하다 урезать кого в правах; ~를 행사하다 вступать в свой права; 한마디로 그녀는 그렇게 말할 권리가 없다 Одним словом, она не в праве говорить так; ~ 관계 правоотношение; ~계승 правопреемство; ~계긍자 правопреемник
적지	적지 敵地; территория, занятая противником; территория противника; ~에 깊숙이 들어가다 проникать в глубину территории врага; проникать вглубь вражеской территории
손실	손실 損失; убыток; ущерб; урон; потери; ~을 입다 понести потери (убытки ); потерпеть ущерб; ~을 주다 причинять (наносить) урон (убытки); 화재로 큰 ~을 입었다 Пожар причинил большие убытки.
타격	타격 打擊; удар; ~하다 бить; ударять; ~을 받다 терпеть удар; ~을 주다 наносить кому удар; 아버지의 사망은 나로서는 큰 ~이었다 Смерть отца была для меня большим ударом.; 대~ сильный (мощный) удар
동기	동기 冬期; = 동계(冬季); ; 동기 動機; повод; мотив; стимул; толчок; ~가 되다 послужить стимулом (толчком) к чему; ; 동기 同期; один период (курс; выпуск); однокурсник, -ца; синхронизм; 작년 ~와 비교해서 сравнивая этот период с периодом в прошлом году; ~ 발전기 синхронный генератор; ~변류기 конвертер; ; 동기 同氣; братья и сестры; ~간에 между братьями (сестрами)
사태	사태 事態; состояние дел; событие; 곤란한 ~ тяжёлое состояние дел; 국가 비상~ чрезвычайное положение дел в государстве; ; 사태 沙汰; обвал; оползень; наплыв; массовый поток; 불경기로 인해 실업자 ~가 났다 Из-за депрессии началась массовая безработица.; 이 ~에서 벗어날 수 있게 도와주세요 Помогите мне выпутаться из этой ситуации.
심각하다	심각 深刻; ~히 глубоко; серьёзно; всерьёз; остро
관여	관여 關與; ~하다 участвовать в чём; иметь отношение к чему
가세	가세 加勢; помощь; подмога; поддержка; ; 가세 家勢; экономическое положение семьи; ~가 넉넉하다 семья в хорошем финансовом положении
권총	권총 拳銃; пистолет; револьвер; ~의 пистолетный; ~으로 위헙하다 угрожать пистолетом (револьвером); ~을 가슴에 들이대다 приставить пистолет к груди; ~집 кобура; 경기영~ спортивный пистолет; 신호영~ сигнальный пистолет; 자동~ пистолет-пулемёт
소형	소형 小型; малый; малого формата; малых размеров; ~ 자동차 малолитражный автомобиль
신록	신록 新綠; цвет свежей травы (зелени); ~이 우거지다 покрыться зеленью; ~으로 덮다 скрыться в густой зелени; ~의 계절 сезон цветения
스치다	слегка задевать (касаться); скользить; промелькнуть; 시원한 바람이 얼굴을 스친다 Свежий ветер скользит по лицу.; 총알이 어깨를 스쳤다 Пуля слегка задела плечо.
배다	1. впитываться; проступать; просачиваться; запасть в душу; становиться привычным; пропитываться; 2. носить (ребёнка; детёныша); быть беременно; давать колос; колоситься; 3. густо; часты; тесны; ограниченны (о взглядах)
징조	징조 徵兆; знак; признак; симптом; намёк; ...의 ~가 되다 становиться признаком чего; ...의 ~를 보이다 намекать на что (о чём); 비가 올 ~가 보인다 Вероятно, будет дождь.; 불길한 ~ дурная примета
괴한	괴한 怪漢; чудак
이루다	создавать; образовывать; составлять; осуществлять; достигать; добиваться; 낙원을 ~ создать рай; 뜻을 ~ добиться своей цели; 잠을 ~ заснуть
쓸다	1. подметать; мести; сметать; 먼지를 ~ мести сор; 그녀는 방을 쓸었다 Она подмела комнату.; 쓰레기를 현관 아래에 쓸어 넣다 сметать мусор под крыльцо; 2.править; точить
목장	목장 牧場; животноводческая ферма
완만	완만 緩慢; медленность; отлогость; ~하다 медленный; медлительный; пологий; ~한 흐름 медленное течение; медленно текущий поток; ~한 비탈 пологий откос
차츰	#NAME?
지붕	крыша; ~이는 사람 кровельщик; 기와로 ~을 이다 покрывать дом черепицей; 기와 ~ черепичная кровля; 둥근 ~ купол
솟다	подниматься; возвышаться; бить ключом; выступать; торчать; топорщиться; прорываться; нахлынуть; 못이 솟아 있었다 Торчал гвоздь.; 불길이 솟는다 Возгорается пламя.; 산 위에 탑 하나가 우뚝 솟아 있다 На горе возвышается башня; 새로운 힘이 솟는 것을 느꼈다 Почувствовал прилив новых сил.; 이 도시에는 고층 건물이 솟아 있다 Возвышается высотное здание в этом городе.; 이마에 땀이 ~ на лбу выступил пот; 해가 솟는다 Восходит солнце.; 땅에서 샘물이 ~ Из-под земли бьёт ключ.
두렁	#NAME?
왼편	왼편 －便; = 왼쪽
옹기종기	кучей; грудой; толпой; плотно
치르다	платить; расплачиваться; переносить; претерпевать; совершать; выполнять; проводить; устраивать; принимать пищу
말머리	начало разговора (рассказа)
건축	건축 建築; строительство; сооружение; возведение; застройка; ~하다 строить; сооружать; возводить; застраивать; ~용의 строительный; предназначенный для строительства; ~공사 строительные работы; ~공학 технология строительства; ~기사 инженер-строитель; ~면적 площадь застройки; ~ 사무소 строительная контора; ~양식 архитектурный стиль; ~업자 строитель; ~ 재료 строительные материалы; стройматериалы; ~ 현장감독 прораб
용건	용건 用件; дело; дела; 급한 ~로 по срочному делу; но срочным делам
나누다	делить, разделять; 4를 2로 ~ делить два на четыре; 반씩 ~ делить по-братски пополам; 슬픔을 친구와 함께 ~ делить горе вместе с другом; 인사를 ~ обменяться приветствиями; 빅또르와 나는 정말로 피를 나눈 형제지간이다 Действительно, мы с Виктором кровные братья.; ~기 деление
영광	영광 榮光; слава; честь; ~스럽다 славный; почетный; 커다란 ~ 으로생각하다 считать что большой честью
들려주다	давать возможность послушать; рассказывать; давать знать кому; 노래를 ~ давать возможность послушать песню; 재미있는 이야기를 들려주시오 Расскажите что-нибудь интересное.
영악	영악 獰惡; ~하다 усердный и неутомимый; ~스레 усердно и неутомимо
노리다	замышлять; задумывать; выжидать;
데리다	брать с собой
석조	석조 石造; сделанное из камня
역시	역시 亦是; тоже; также; конце концов; как и ожидалось
갖추다	иметь; подготавливать; держать; приводить в порядок; обставлять; располагать; снабжать; 당당한 풍채를 ~ иметь внушительный вид; 방어 태세를 ~ занять оборонительную позицию; приготовиться к обороне
덧	добавочный; дополнительный; поверх чего; ~보태다 дополнительно добавлять; ~옷 верхняя одежда; ~입다 надевать поверх чего
인부	인부 人夫; чернорабочий; землекоп; грузчик; стивидор
손질	отделка; обработка; доработка; приведение в порядок; уход; починка; ~하다 дорабатывать; обрабатывать; отделывать; 집을 ~하다 ремонтировать дом; 의복을 ~하다 почистить (погладить) костюм; 화초의 ~하다 уход за цветами; 밭의 ~하다 уход за посевами
잔디	дёрн; газон; трава
세밀	세밀 細密; деталь; ~하다 детальный; тщательный; ~히 детально; тщательно
살피다	рассматривать; 창밖을 ~ смотреть в окно; 방안을 ~ рассматривать комнату
가운데	середина; центр; ~형 средний брат; ~를 자르다 разрубить посередине; внутренняя часть; ~로 들어가다 вступить на середину; 깊은 물 ~로 가라앉았다 утонуть глубоко в воде; середина; между; ~에 있다 находиться между; среди; 여럿 ~서 고르다 выбрать из нескольких; 가난한 생활 ~서 живя в бедности
꾸미다	1. украшать; декорировать; 2. шить; 3. притворяться кем-либо; врать; приукрашивать; 4. составлять; организовывать; 5. задумывать; замышлять; 꾸미지 않은 безыскусственный; бесхитростный; незатейливый; 꾸밈 затея; 꾸미지 않고 без затей (украшения); 문서를 ~ составлять документ; 방을 꽃으로 ~ украшать комнату цветами; 아픈 척 ~ притворяться больным; 음모를 ~ замышлять заговор; 이불을 ~ шить одеяло
구실	роль; долг; ~을 하다 играть роль; 제~을 하다 исполнить свой долг; ; 구실 口實; предлог; повод; оправдание; ...을 ~삼아 под предлогом; ~을 만들다 выдумывать предлог (отговорку); ~을 주다 дать повод
면밀	면밀 綿密; ~하다 тщательный; внимательный; подробный; обстоятельный; детальный
빗장	засов; задвижка
밀다	1. толкать; отталкивать; 2. строгать; брить
끼우다	вставлять; вкладывать; втыкать; допускать к участию в чём; 땅에다 말뚝을 ~ втыкать кол в землю; 끼움 вставка; 끼우는 창틀 вставная оконная рама; 부록을 끼워서 책을 비싸게 팔다 продавать дорого книгу с приложением
절대	절대 絶對; абсолютность; безусловность; ~의 абсолютный; категоричный; ~로 абсолютно; совершенно; категорически; безусловно
쓰다듬다	1. гладить; поглаживать; 2. утешать; уговаривать
반죽	тесто; ~하다 замешивать; месить
천장	천장 天障; потолок; ~에 매달려 있다 висеть на потолке
검소	검소 儉素; ~하다 скромный
씌우다	надевать что-либо на кого-либо, что-либо; 죄인에게 족쇄를 ~ надевать на преступника кандалы
까다	1. очищать; чистить; лущить; колоть; 사과 껍질을 ~ очищать яблоко; 완두콩 깍지를 ~ чистить горох; 2. выводить (цыплят); сидеть на яйцах; 병아리를 ~ выводить цыплят; 3. бить; сильно избивать; наносить увечья; 적을 ~ наносить врагу увечья
정사각형	정사각형 正四角形; квадрат
카펫	
판자	판자 板子; доска; ~를 대다 обшивать досками
널빤지	доска, обшивная доска или планка
참나무	дуб; ~누에 гусеница дубового шелкопряда; ~누에고치 кокон дубового шелкопряда
사방	사방 四方; четыре стороны света; вокруг; всюду; везде; 남자가 신경질적으로 ~을 종종 쳐다봤다 Мужчина нервно смотрел по сторонам.
세심	세심 細心; ~하다 внимательный; тщательный; скрупулёзный
늘어지다	удлиняться; растягиваться; свисать; обвисать; замедляться; сникнуть; размякнуть; спокойный; 늘어지게 잠을 자다 отоспаться; выспаться; 팔자가 ~ жить спокойно; 버드나무 가지가 늘어진다 Ветки ивы свисают.
베개	подушка; ~가 너무 높다 Подушка слишком высокая.; 환자 머리맡에 ~를 대어주었다 Больному подложили под голову подушку.
엎드리다	ложиться ничком (плашмя); пасть ничком
시선	시선 視線; взгляд; взор; ...와 ~이 마주치다 встретиться взглядом с кем; ~을 던지다 бросить взгляд; ~을 돌리다 обращать (устремлять) взор; ~을 피하다 укрываться от взгляда; ~을 향하다 направить взгляд на кого-что; взглянуть на кого-что
잡아당기다	тащить (к себе); перетягивать (на свою сторону)
울리다	звучать; раздаваться (о звуках); заставлять плакать; волновать; заставлять звучать; 심금을 울리는 이야기 трогательный рассказ; 종이 울린다 Колокол звонит
환기	환기 喚起; привлечение; ~하다 привлекать; вызывать; пробуждать; поднимать на что; ; 환기 換氣; вентиляция; проветривание; ~하다 проветривать; вентилировать; ~가 좋은 хорошо вентилируемый (проветривающийся); ~ 장치 вентиляционное устройство
매다	1. завязывать; связывать; привязывать; держать; крутить; 파란 넥타이를 ~ завязывать синий галстук; 목을 ~ повеситься; 2. полоть; пропалывать; 김을 ~ полоть гряды
멍청하다	~하다 растерянный; ошеломлённый; глупый
목수	목수 木手; = 목공; ; 목수 木髓; = 고갱이
무렵	время; момент; пора; 그 ~에 тогда; в те времена; 바로 이 ~에 как раз в это время; 동틀 ~에 к рассвету; 저녁 ~에 к вечеру; 일이 끝날 ~에 когда заканчивали работу; 1990년 ~부터 примерно с 1990 года
의학	의학 醫學; медицина
서적	서적 書籍; книга
꽉	крепко; сильно; до предела; полностью; 생각이 머리에 ~ 차다 Голова забита мыслями.; 숨이 ~ 막히다 дыхание сперло; 가방에 책을 ~ 채우다 набивать портфель книгами
소박하다	소박 疏薄; ~하다 не любить жену; пренебрежительно относиться (к жене); 소박 素朴; ~하다 простой; безыскусственный; наивный
둥글다	круглый; становиться круглым; округляться; 둥근 얼굴 круглое лицо; 둥글게 하다 округлять
따위	подобный чему-либо; типа чего-либо; 너 ~ такие как ты, ты и тебе подобные
접시	тарелка; блюдце
윤곽	윤곽 輪廓; очертание; контуры; очерк; ~을 그리다 нарисовать контуры
돌돌	~말다 скатывать в трубочку
말리다	1. сушить; высушивать; вялить; 2. отговаривать; не советовать; унимать; разнимать; оберегать
충고	충고 忠告; совет; ~하다 советовать
맹세	맹세 ←盟誓; клятва; ~하다давать клятву
새우다	не спать ночью; 공부로 밤 ~ заниматься всю ночь
핑계	предлог; повод; оправдание; ~하다 (~를 대다) находить предлог; ссылаться на что; ~ 없는 무덤이 없다 избегать ответственности, ссылаясь на что; 제법 그럴싸한 ~를 대어 под благовидным предлогом
자그마하다	~하다 небольшой; невысокий; крохотный
육중	육중 肉重; ~하다 громоздкий; массивный; грузный; ~한 몸집 грузное тело; ~한 설비 массивное оборудование
철문	철문 鐵門; железная дверь
여느	обычный; обыденный; другой (другие)
고함	고함 高喊; громкий крик; ~(을) 지르다 громко кричать; орать; ~(을) 치다 истошно кричать
지르다	кричать; громко петь; с силой ударять; ткнуть; пнуть; втыкать; вонзать; вставлять; всовывать; закрывать дверь на засов; разводить; идти напрямик; 고함을~ кричать; 발로 정강이를~ ударить кого по ногам; 빗장을 ~ запирать дверь на засов; 집에 불을~ поджигать дом; 질러가는 길이 돌아가는 길이다 Тише едешь - дальше будешь.
걸걸	~하다 сильный; ~한 목소리 сильный голос
기세	기세 氣勢; дух; сила духа; ~가 등등하다 торжествующий; исполненный гордости собственной мощью; ~가 충천하다 быть полным энтузиазма; окрыляться; воодушевляться
켜지다	크다 + 지다
점차	점차 漸次; постепенно; понемногу; мало-помалу; шаг за шагом
장치	장치 裝置; оборудование; устройство; аппарат; ~하다 устраивать; устанавливать; оборудовать; 안정~ предохранитель
고정	고정 固定; закрепление; фиксация; ~적 фиксированный; устойчивый; стабильный; постоянный ; ~하다 фиксировать; закреплять; делать устойчивым (стабильным); ~불변 постоянство и неизменность; ~가격 стабильные цены; ~관념 стереотип; устойчивое мышление; навязчивая идея; идея фикс; ~목표 неподвижная цель; ~수입 постоянный доход; 자본 основной капитал; ~자산 недвижимость
용도	용도 用途; применение; назначение (предмета); использование; ~가 넓다 широко применяться (использоваться); употребляться для разных нужд
가까스로	едва; с трудом; насилу; ~ 싸움을 말렸다 с трудом остановил драку
맞추다	1. (조립하다) собирать; монтировать; 기계를 ~ собрать механизм (машину); 자동차를 ~ собрать автомобиль; 분해해던 시계를 ~ пересобрать часы ; 2. (맞게 하다) делать правильно; корректно; привести в порядок; 계산을 ~ исправить вычисления; 3. (적합하게 하다) подогнать; делать по вкусу; подходить; годный; пригодный; соответствующий; надлежащий; 음악에 맞추어 춤추다 танцевать под музыку; 안경 도수를 ~ подогнать точность очков; 간을 ~ придавать чему острый (солёный) вкус; 맛을 ~ придавать надлежащий вкус; 4. (주문하다) заказать; 맞추어 만든 сделанный на заказ; 구두를 ~ заказать туфли; 5. (약속하다) обещать; договариваться; 날짜를 ~ договориться о дате; 6. (알아맞히다) догадываться; полагать; предполагать; разгадывать; 나 어디 있는지 맞춰 봐! попробуй догадаться, где я!; 제 생일 선물로 뭘 사셨어요?―한번 맞춰 봐라 Что ты купил мне на день Рождения? Попробуй угадать.; 7. (대조하다) сравнивать; сопоставлять; сличать; сверять; 맞추어 보다 сличать; сверять; 원문과 ~ сравнивать с оригиналом; 8. 입을 ~ (по)целовать
비기다	сыграть (закончиться) вничью; составлять баланс
마음먹다	решиться на что-л.
대담	대담 大膽; ~ 성 смелость; отвага; дерзость; ~스럽다; ~하다 смелый; отважный; дерзкий; 대담무쌍하다 бесстрашный; беспримерно отважный; ; 대담 對談; беседа; ~하다 беседовать; 격의 없는 задушевный разговор
성과	성과 成果; результат; достижение; успех; ~를 거두다 достигнуть результата; ~를 올리다 пользоваться успехом; 그의 ~는 우리들의 ~에 비하면 빛이 나지 않는다 Их успехи бледнеют перед нашими.
겸비	겸비 兼備; ~하다 сочетаться; совмещать(ся); 재색(才色)을 ~하다 сочетать ум и красоту
겪다	испытывать; переносить; терпеть; угощать
꺼지다	1. потухать; гаснуть; 2. исчезать; 3. проваливаться; 불이~ гаснуть (огонь); 꺼져라! Проваливай!; Пошёл к черту!; ; 꺼지다 ; проваливаться; оседать;; ввалиться; впадать; 마룻바닥이~ пол проваливается; 눈이 움푹~ глаза ввалились
칠흑	pitch-black; coal-black; jet-black.
광채	광채 光彩; блеск; сияние; ~가 나다 блестящий
번뜩	with a flash.
정면	정면 正面; фронт; фасад; передний; ...의 ~에 перед чем; впереди чего
등대	등대 燈臺; маяк
노릇	роль; функция; занятие; работа; жалкое (бедное) положение; 목수 ~을 하다 работать столяром, ; 주인 ~을 하다 хозяйничать; 저런 딱한 ~이 있나 Какая беда (бедствие)!; 참 교육자 ~을 하기란 쉽지 않은 일이다. Быть настоящим педагогом - нелёгкое дело.
허물	недостаток; дефект; промах; ошибка; проступок; вина; ~을 벗다 смывать позор
형체	형체 形體; форма; фигура; корпус; остов
뛰어나오다	выбегать из ..
동요	동요 動搖; колебания; волнения; колебание; нерешительность; неустойчивость; флуктуация (флюктуация); ~하는 колеблющийся; нерешительный; неустойчивый; ~하다 колебаться; волноваться; не решаться; флуктуировать; ~없이 без колебаний; 민중의 ~ народные волнения; 사상의 ~ брожение идей; ; 동요 童謠; песня для детей; детская песня; ~ 경연대회에 참가하다 участвовать в конкурсе песен для детей; ~를 부르다 петь детскую песню
애완동물	любимый питомец
습격	습격 襲擊; налёт; штурм; нападение; ~하다 нападать; атаковать; штурмовать; совершить налёт; ~ 당하다 подвергаться налёту (нападению)
바짝	#NAME?
간신히	간신히 艱辛－; едва; с трудом; ~ 이기다 с трудом победить; ~ 먹고 살아가다 с трудом выживать
대비	대비 對備; подготовка; ~하다 подготовиться; 만반의 ~를 하다 подготовиться на всякий случай; 사전에 시험에 ~하다 заранее подготовиться к экзаменам; ; 대비 對比; сопоставление; сравнение; контраст; ~하다 сопоставлять с кем-чем; сравнивать с кем-чем; контрастировать кому-чему (с кем-чем); 사본을 원본과 ~하다 сопоставлять копию с подлинником; 사신의 의견을 다른 사람과 ~하다 сравнивать свое мнение с другим
지팡이	трость; посох
양초	양초 洋－; парафиновая свеча; ~ 심지 фитиль
이내	이내 以內; в пределах чего; не свыше; 다섯시 ~에 не позже пяти часов; 삼십일 ~에 в течение тридцати дней
캄캄하다	~하다 очень тёмный; мрачный; беспросветный; слабый; незнающий; тёмный; невежественный
쉽사리	легко; 문제를 ~풀다 легко решить задачу
차단	차단 遮斷; перехват; помеха; изоляция; карантин; ~하다 загораживать; отключать; отрезать от кого-чего; перехватить; прерывать; заслонить; 퇴로를 ~하다 отрезать путь к отступлению
실낱	отдельная нитка; ~같다 очень тоненький; ~같은 한 가닥 희만 едва теплящаяся (слабая) надежда; ~같은 목소리로 속삭이다 шептать тоненьким голосом
음색	음색 音色; тембр; тон
덮개	1. покрывало; накидка; 2. крышка
인기척	인기척 人－; признаки присутствия кого; ~이 났다 появились признаки присутствия человека
주전자	주전자 酒煎子; чайник
수증기	수증기 水蒸氣; водяной пар
환하다	яркий; светлый; ясный; явный очевидный; открытый; широко простирающийся; свежий; гладкий; освежающий; прохладный; знакомый; осведомлённый
쏘다	ныть; ломить; жалить; задевать; говорить колкости; пронизывать взглядом; сбивать (самолёт); 나는 꿀벌에게 심하게 쏘였다 Пчела больно меня ужалила.; 이가 쏜다 Зубы ноют.; ...의 아픈 곳을 ~ задевать кого за живое
혐오	혐오 嫌惡; отвращение; ненависть; ~하다 ненавидеть; ~의 감정을 품다 питать ненависть к кому-чему; ~한(~스러운) ненавистный; отвратительный; гнусный; омерзительный; гадкий
동작	동작 動作; движение; действие; ~하다 двигаться; действовать; быть в действии; 손~ движение рук
소름	мурашки; ~끼치다 мурашки бегают по спине; мороз по коже пробирает; ~이 돋다 покрыться мурашками
분노	분노 忿怒·憤怒; гнев; негодование; ~하다 негодовать; гневаться
온몸	все тело; ~몸이 떨리다 дрожать всем телом; ~몸에 по всему телу
절규	절규 絶叫; громкий крик; вопль; ~하다 громко кричать о чём; вопить о чём
변두리	변두리 邊－; край; окраина
얼다	замерзать; коченеть (от холода); падать духом; становиться застенчивым (неловким); 얼어붙은 леденистый; 강물이 얼어붙었다 Река покрылась льдом; 내 손은 방안에서 도 언다 Руки у меня замерзают даже в комнате.; 두려움에 심장이 얼어붙는 것 같다 Ужас леденит сердце.; 물이 얼기 시작하다 Вода начинает замерзать.; 바람에 몸이 얼어붙었다 Ветер холодит тело.
심정	심정 心情; душа; сердце; 나는 그의 ~을 모르겠다 Я не знаю, что у него на душе.; 자신의 ~을 털어놓다 открывать кому своё сердце; изливать душу
마주	прямо; лицом к лицу; друг к другу; навстречу; взаимно; ~ 가다 идти навстречу; 손을 ~ 잡다 обмениваться рукопожатиями
응답	응답 應答; ответ; отклик; реакция; ~하다 откликаться; отвечать
발사	발사 發射; выстрел; стрельба; пальба; запуск; ~하다 стрелять; палить; вести огонь; запускать; 로켓을 ~하다 запускать ракету; ~장치 пусковая установка
기이	기이 奇異; ~하다 странный; причудливый; удивительный; ~함 странность; причудливость; удивительность; ~하게 странно; причудливо; удивительно; ~한 옷차림 причудливый наряд
절반	절반 折半; половина; ~씩 나누다 делить пополам (надвое)
비추다	освещать; озарять; просвечивать (что-л. лучами); отражаться; быть отражённым; 전등으로 어구운 구석을 ~ освещать фонарём тёмные уголки; 가로등이 잠시 비추더니 꺼져버렸다 Фонари посветили и потухли.
맨발	голые (необутые) ноги; ~로 босиком; ~(을) 벗다 быть босым (разутым)
슬리퍼	슬리퍼 slippers; комнатные туфли; тапочки
드러내다	обнаруживать; выявлять; проявлять; показывать; обнажать; выражать; 대단한 재능을 ~ обнаружить большие способности
모퉁이	угол; закоулок; уголок; часть; 길 ~ поворот дороги; угол улицы; ~를 돌아 за углом
경직	경직 梗直; ~하다 волевой и искренний (прямой); ; 경직 硬直; твёрдость; непреклонность; жёсткость; негибкость; ~된 отверделый; окостенелый; ~하다 отвердеть; окостенеть
바싹	вплотную; плотно; туго; ~ 마르다 засохнуть; пересохнуть; ~ 마른 тощий; кожа до кости; 띠를 ~ 죄다 туго затянуть ремень; 정신을 ~ 차리다 держать себя в руках; сдерживаться
폭력	폭력 暴力; насилие; насильственные действия; ~적 насильственный; ~을 행사하다 применять силу (насилие); действовать насильственными методами; ~ 투쟁 насильственная борьба
되돌아오다	приходить (приезжать) обратно; обратно возвращаться
함정	함정 艦艇; военные корабли и катера; ; 함정 陷穽; яма для ловли животных; ловушка; западня; ∼에 빠지다 попасть в западню; ~에 빠뜨리다 поймать в ловушку
빠뜨리다	подвергать; терять; пропускать; 곤란한 입장에 ~ подвергать трудному положению; 한 줄을 ~ пропускать одну строку; 지갑을 ~ терять кошелёк
구덩이	яма; впадина; ухаб
진상	진상 眞相; действительное положение вещей; действительная картина
경위	경위 涇渭, 經緯; суть дела; ход (обстоятельства) дела; положение вещей; ~를 말하다 рассказывать о том, как всё было
장황	장황 張皇; ~하다 сложный (путаный) и длинный; пространный; нудный; долгий
이튿날	второе число; следующий (другой) день; 칠월 ~ второе июля; ~ 아침 на другое утро
언뜻	мельком; украдкой; неожиданно; внезапно; вдруг; ~ 눈에 띄다 быстро промелькнуть; ~ 보다 мельком взглянуть; бегло просматривать; ~ 생각이 떠오르다 кого осенять мыслью; ~보기에 на первый взгляд
즉시	즉시 卽時; немедленно; незамедлительно; сразу же; ~불 немедленная уплата
주목	주목 朱木; тисе тонкозаострённый; ; 주목 注目; взор; внимание; ~하다 обращать на себя все взоры; обращать внимание
사들이다	закупать; 공장 생산품을 모두 ~ закупать всю продукцию завода; 월동 준비로 장작을 ~ закупать дрова на зиму; 오찬을 위해 식료품을 ~ закупать продукты к обеду; 식품을 대량으로 ~ закупать продукты в большом количестве
결부	결부 結付; ~하다 связывать что с чем; ...에 ~해서 в связи с чем
실험	실험 實驗; эксперимент; опыт; испытание; ~의 экспериментальный; опытный; испытательный; ~된 испытуемый; ~하다 испытывать; экспериментировать над (с) кем-чем; ~중이다 быть на испытании; ~물리학 экспериментальная физика; 원폭 ~ испытание атомных бомб; 핵~ ядерные испытания; 화학 ~ химический эксперимент
발각	발각 發覺; раскрытие; ~되다 обнаруживаться; разоблачаться
착상	착상 着想; мысль; замысел; концепция; ~하다 приходить в голову (о мысли); 기발한 ~이 떠올랐다 Пришла в голову потрясающая идея.; ~을 실현시키다 осуществлять замысел; 작가적 ~ авторский замысел; 전략적 ~ стратегический замысел; 위험한 ~ опасный замысел
잔인	잔인 殘忍; ~하다 жестокий; безжалостный; зверский
썩	очень; хорошо; сразу же; тут же; отчётливо; заметно; ~ 물러가라Пошёл вон!; ~ 좋다 Очень хорошо.; 그는 노래를 ~ 잘 부른다 Он поёт очень хорошо.
어울리다	подходить к кому-чему; быть к лицу; объединяться с кем; общаться с кем; 이 색깔들은 서로 잘 오울린다 Эти цвета хорошо подходит один к другому.; 이 옷이 당신에게 잘 오울린다 Эта одежда вам очень идёт.
작용	작용 作用; действие; процесс; ~하다 действовать; 화학~ химический процесс; ~과 반작용 действие и противодействие (реакция); 상호 ~하다 взаимодействовать
택하다	택하다 擇－; выбирать; избирать; отбирать; предпочитать кого-что кому-чему
보장	보장 保障; гарантия; обеспечение; снабжение; ~하다 гарантировать; обеспечивать; снабжать; 이것은 세계 평화를 ~할 것이다 Это обеспечит мир во всем мире.; 신분 ~ гарантия стабильности; 평화~ обеспечение мира
희생	희생 犧牲; жертва; ~적 героический; самоотверженный; ~하다 жертвовать чем-кем; приносить кого-что в жертву; ~을 치르다 приносить жертвы; 어떠한 ~을 치르더라도 любой ценой; ...을 ~하여 за счет чего; в ущерб чему; ~ 정신 дух самопожертвования
모면	모면 謀免; ~하다 уклоняться; избегать
올라서다	
뻗다	растянуться; слечь; 앞으로 손을 곧게 뻗으세요 Вытяните руки вперед.
금속성	금속성 金屬性; свойства металлов
잡기	잡기 雜技; азартные игры; 주색~ женщины, вино и азартные игры; ; 잡기 雜記; заметки; беспорядочные записи; ~하다 делать беспорядочные записи
쉭쉭	
공격	공격 攻擊; атака; штурм; наступление; нападение; нападки; ~적 наступательный; ~하다 атаковать; штурмовать; наступать; нападать; критиковать; 기습~ внезапное нападение; 정면~ фронтальное наступление; лобовая атака; 측면~ фланговая атака
본성	본성 本性; природа; (подлинный; истинный) характер; сущность; ~을 드러내다 показать своё настоящее лицо
가책	가책 呵責; нагоняй; выговор; встрепка; нахлобучка; 양심의 ~ угрызения совести; раскаяние; ~하다 бранить; ругать; упрекать; укорять