항구	항구 港口; гавань; порт; ~ 도시 портовый город
마침	как раз; кстати; именно; 자네가 ~ 왔군 Ты пришёл кстати.
밀물	приливное течение; прилив
육지	陸地; земля; суша; ~에 на суше
몰려들다	входить гурьбой (толпой)
어선	漁船; рыбачья лодка; рыболовное судно
세차다	очень сильный; мощный
부딪히다	сталкиваться; разбиваться; 배가 바위에 부딪혔다 Корабль разбился о скалу.
감시소	監視所; наблюдательный пункт
숙직	宿直; ночное дежурство; ~하다 дежурить (сторожить) ночью
반도	半島; полуостров; 한~ корейский полуостров
통조림	桶－; консервы; 고기(생선)~ мясные (рыбные) консервы
성행	盛行; ~하다 широко распространяться; становиться известным (модным)
광장	廣場; площадь; просторный двор; 붉은 ~ Красная площадь; 역전~ привокзальная площадь
모퉁이	угол; закоулок; уголок; часть; 길 ~ поворот дороги; угол улицы; ~를 돌아 за углом
환하다	яркий; светлый; ясный; явный очевидный; открытый; широко простирающийся; свежий; гладкий; освежающий; прохладный; знакомый; осведомлённый
새다	течь, протекать; 가스가 샌다 Газ протекает.; 물통에서 물이 샌다 Вода протекает из ведра.
부럽다	испытывать зависть; 나는 그의 행운이 ~ Я завидую его счастью.; 부러운 завидный
간혹	間或; иногда; временами; изредка; время от времени; 그는 ~ 술을 마신다 Он выпивает время от времени.
트럼프	карты
흥얼거리다	напевать про себя; мурлыкать
별안간	瞥眼間; вдруг; неожиданно; врасплох; ~에서 따로 만나자 Случилось неожиданное дело и я не знаю его причины.
날리다	подниматься; разноситься; развеваться; трепетать; полоскаться; запускать в воздух; поднимать вверх; делать на скорую руку; халтурить; полностью израсходовать; растрачивать; упустить случай; прославиться (кем-чем.); 새장에서 새를 ~ выпускать птицу из клетки; 좋은 기회를 ~ упустить хороший шанс; 깃발이 바람에 날린다 Флаг развевается на ветру.; 남의 돈을 와전히 날렸다 растратил чужие деньги; 눈발이 바람에 날린다 Снежинки разносятся ветром.; 모형비행기를 공중으로 날렸다 Пустил макет самолёта в воздух.; 방안에 먼지가 날린다 В комнате поднялась пыль.; 유명한 학자로서 이름을 날렸다 Он прославился как учёный.
구르다	1. катиться; 2. топать; 발을 구르며 기뻐하다 притоптывать ногами от радости
허둥지둥	неугомонно; суетливо; нервно; нервозно; торопливо; поспешно; беспокойно
더구나	вдобавок; кроме того; сверх того; к тому же; 말을 함부로 하는데다 ~ 거짓말까지도 한다 Грубит, да в добавок еще и лжет
더욱더	more and more;
우스꽝	смешной
킬킬거리다	сдержанно смеяться
이윽고	спустя некоторое время
구부리다	сгибать; изгибать
홱	резко; круто; порывисто; живо; быстро
비틀거리다	идти пошатываясь
뒷걸음질	stepping backward;
고랑	борозда; ; 고랑 ; наручники; ~을 채우다 надевать наручники; заковывать в кандалы
박다	забивать; вбивать; втыкать; класть; начинять; засовывать; штамповать; печатать; снимать; фотографировать; шить; делать стежки; 벽에 못을 ~ вбивать (забивать) гвоздь в стену; 쐐기를 ~ вбить клин
꼼짝	~하다 еле двигаться; ~못하다 быть не в состоянии шевельнуться; быть связанным по рукам и по ногам; ~안하다 не шелохнуться; не изменить мнения; стоять на своём; ничего не делать; палец о палец не ударить; не казать носа куда-либо; слова не сказать против кого-либо
맡다	 smell (at) <a flower> / take a smell <at>
슬금슬금	незаметно; тайком; втихомолку; без усилий
부근	附近; окрестность; близость; соседство; 서울 ~ окрестности Сеула; ~에 아무도 없었다 В окрестности не было никого.
뚫리다	1. продырявливаться, худиться; проделываться; образовываться (об отверстии, дырке) ; 그는 구멍 뚫린 회색 양말을 신고 있었다. На нём были дырявые серые носки.; 2. прокладываться; строиться (о пути, дороге) ; 3. расчищаться; освобождаться (о дорожном заторе) ; 4. (в образ. выраж.) ; 뚫린 입이라고 함부로 지껄이지 마라. Не бросайся болтать, не подумав.; 조세 체계에 큰 구멍이 뚫렸다. В налоговой системе образовалась брешь.; 주전 선수들의 부상으로 우리 팀 수비에 구멍이 뚫렸다. Из-за ранения главных игроков, в защите нашей команды образовалась брешь.
검붉다	тёмно-красный
다물다	закрывать; сжимать; 꼭 다문 입술 крепко сжатые губы; 입을 ~ сжимать губы; молчать
카운터	англ. counter; кассир; касса
팔꿈치	локоть; ~로 찌르다 подтолкнуть локтем; ~는 가까워도 깨물지는 못한다 Близок локоть, да не укусишь.
곁	бок; ~에 сбоку; рядом; около; покровитель; ~(이) 비다 одинокий; беззащитный
드러눕다	лечь; улечься
튀다	отскакивать; трескаться; лопаться; рассыпаться; разогнувшись, сойти со своего места; сбежать; брызгать; разлетаться; заметно выступать (выделяться)
외마디	одно колено; один сегмент; одно слово; одна фраза
지르다	кричать; громко петь; с силой ударять; ткнуть; пнуть; втыкать; вонзать; вставлять; всовывать; закрывать дверь на засов; разводить; идти напрямик; 고함을~ кричать; 발로 정강이를~ ударить кого по ногам; 빗장을 ~ запирать дверь на засов; 집에 불을~ поджигать дом; 질러가는 길이 돌아가는 길이다 Тише едешь - дальше будешь.
맞다	1. попадать во что; попадать подо что (в что); получать что; принимать кого; 총알이 바로 맞았다 Пуля попала в цель.; 비를 ~ попадать под дождь; 폭풍을 ~ попадать в буран; 눈보라를 ~ попадать в метель; 봄을 ~ встречать весну; 퇴짜를 ~ быть отвергнутым; 매를 ~ быть (по)битым; 뺨을 ~ получить пощёчину; 총을 ~ получить пулю; 주사를 ~ получать укол; 손님을 ~ принимать гостей; 도적을 ~ быть ограбленным; 남편을 ~ выходить замуж; 아내를 ~ жениться; 사위를 ~ выдавать дочь замуж; 2. подходить; соответствовать; совпадать; быть (оказаться) впору; быть правильным (точным); 이 옷이 너에게 맞는다 Этот костюм тебе идёт (тебе к лицу).
총구	銃口; дульная часть; дуло
건지다	(из воды) вынимать; вытаскивать
구급차	救急車; машина скорой помощи
도매상	都賣商; оптовик; оптовый торговец
기르다	выращивать; выхаживать; откармливать; воспитывать; выпестовать; воспитывать; прививать; отращивать; запустить; 아이들을 ~ выращивать детей; 우수한 전문가를 ~ воспитывать способных специалистов; 음악에 대한 취미를 ~ прививать вкус к музыке
머리통	окружность головы; башка
개이다	прояснеть (о погоде); рассеиваться (о тревоге); 비가 ~ Дождь кончается.
무렵	время; момент; пора; 그 ~에 тогда; в те времена; 바로 이 ~에 как раз в это время; 동틀 ~에 к рассвету; 저녁 ~에 к вечеру; 일이 끝날 ~에 когда заканчивали работу; 1990년 ~부터 примерно с 1990 года
시찰	視察; инспекция; осмотр; ~하다 инспектировать; осматривать; ~단 комиссия инспекторов; группа наблюдателей
소재지	所在地; место расположения (чего); административный центр; 도~ провинциальный административный центр
의뢰	依賴; просьба; поручение; ~하다 полагаться на кого; зависеть от кого; просить кого о чём; поручать кому что;
이튿날	второе число; следующий (другой) день; 칠월 ~ второе июля; ~ 아침 на другое утро
가라앉다	1. тонуть; затонуть; 2. успокаивать; успокоить; умиротворять; униматься; 바람이 가라앉았다 ветер стих; 3. исчезать; утихать; отгреметь; улечься; замирать; угасать; 그의 열은 가라앉았다 У него упала температура
줄기차다	неустанный; непрерывный; непрестанный; безостановочный; непрекращающийся; сплошной; сильный; мощный; могучий; энергичный; активный; 줄기찬 의지 непреклонная воля; 줄기차게 일하다 непрестанно трудиться; 줄기차게 비가 내리다 неустанно и сильно идёт дождь; дождь льёт как из ведра; 줄기차게 담배를 피우다 непрерывно курить
물다	держать (во рту, в клюве); кусаться; хватать; 담배를 ~ держать сигарету во рту; ; 물다 ; платить; возмещать; 얼마나 물어야 합니까? Сколько с нас?
어쩐지	почему-то; отчего-то; неудивительно, что; вот почему; ~ 그가 기쁜 얼굴을 하고 있너라 Это объясняет его радостное лицо.
음산	陰散; ~하다 пасмурный; хмурый; неуютный; мрачный
한눈	~(을) 팔다 смотреть по сторонам; заглядываться; 산에서 온 마을이 ~에 보인다 С горы вся деревня видна как на ладони.
단골	1. излюбленное место (кого-л.); ~식당 излюбленная столовая; 2. постоянный посетитель
혈색	血色; цвет лица; покраснение кожи; румянец; цвет крови; 그는 ~이 나쁘다 Он бледен.; 그는 ~이 좋다 У него здоровый цвет лица.
둥글다	круглый; становиться круглым; округляться; 둥근 얼굴 круглое лицо; 둥글게 하다 округлять
입가	уголки рта
여태	до сих пор; до сего времени, последствия
활약	活躍; деятельность; активность; ~하다 играть активную роль; быть активным; активно действовать
등대	燈臺; маяк
재산	財産; имущество; состояние; 국유~ государственное имущество; 사유~ частное (личное) имущество; 지적 ~ интеллектуальная собственность; ~목록 опись имущества; ~몰수 конфискация имущества
편안	便安; спокойствие; благополучие; ~하다 спокойный; благополучный; ~히 спокойно; благополучно; ~히 주무십시오 Спокойной ночи.; 만사가 ~하다 всё обстоит благополучно
일어서다	подниматься; вставать (на ноги); вставать и идти вперёд
은빛	銀－; серебристый цвет
콧수염	-鬚髥; усы
승마	乘馬; верховая лошадь; ~하다 садиться верхом
멋	вкус; элегантность; щегольство; ~을 내다 щеголять; модничать
면허	免許; разрешение; одобрение; патент; 운전 ~증 водительские права; разрешение на управление транспортного средства
별장	別莊; дача; загородный дом; 내 친구는 경치 좋은 곳에 ~을 마련하였다 Мой друг приобрёл дачу в хорошем месте.; ~지기 дачный сторож
차다	холодный; прохладный; промозглый; заполняться; наполняться; оканчиваться; истекать; ударять ногой; давать пинок; лягать; прицеплять (саблю); прикреплять (орден); 마음에 ~ быть довольным чем нравиться кому; 공을 ~ бить по мячу; 게를 ~ ударить ногой собаку; 혀를 ~ прищёлкнуть языком; 문을 ~ пнуть ногой дверь; 정강이를 ~ ударить (пнуть) по ногам; 칼을 ~ быть при шпаге; 혁대를 ~ скреплять ремнями; 그녀의 눈은 눈물로 가득 찼다 Её глаза наполнились слезами.; 강은 통나무들로 가득 찼다 Река была загружена брёвнами.; 조수는 하루에 두 배나 찼다 Прилив и отлив происходит два раза в сутки.; 그의 임기는 내년에 찬다 Срок его пребывания на посту истекает в будущем году.
비뚤다	crooked; awry; wry; skew
붉다	красный; 붉은 광장 Красная площадь
기울이다	склонять; наклонять; сосредотачивать; 고개를 ~ наклонять голову; 귀를 ~ прислушиваться; склонить ухо к чему; 힘을 ~ прилагать усилия к чему; вкладывать душу во что
마주치다	натыкаться на кого, сталкиваться с кем; 시선이 ~ встречаться взглядами; 문에서 아버지와 ~ сталкиваться с отцом в дверях
스커트	skirt; юбка
앞치마	передник; кухонный фартук; 설거지를 할 때 ~를 두르다 надевать фартук при мытьё посуды
두르다	окружать; огибать; обходить по краю; окутывать; обматывать; обвязывать; надевать; 목도리를 목에 ~ обвязать шею шарфом; 머리에 수건을 ~ повязать голову платком
노려보다	пристально смотреть на (кого-что); бросать алчные взгляды; 매서운 눈초리로 ~ бросить свирепый взгляд
되쏘다	 shoot back;
오히려	наоборот; скорее всего
어찌	как; каким образом; почему; отчего; ~ 할 수 없이 поневоле; вынужденно; ~ 할 줄 모르다 не знать, что делать
저런	вот это да; неужели
끔찍	чрезвычайный; ужасный;
악질	惡疾; серьёзное заболевание; тяжёлая болезнь; ; 악질 惡質; порочность; злодей; порочный человек; злюка; ~적 порочный; злющий
소행	所行; проделанная работа; совершённый поступок; поведение
지껄이다	болтать; проговариваться; выбалтывать; разбалтывать; распускать язык; тараторить; трепаться; 두서없이 ~ говорить бессвязно; у кого язык без костей; 쉬지않고~ тараторить; 함부로~ трепать языком; давать волю языку; 잘 지껄이는 사람 болтун
줄거리	интрига; сюжет рассказа; фабула; ~의 전개 развитие сюжета
간밤	вчерашний вечер; прошлая ночь
잔소리	ворчание; брюзжание; ~하다 ворчать; брюзжать
빈집	пустой (заброшенный) дом
우편함	郵便-; почтовый ящик
지우다	1. грузить; нагружать кого-что чем (кого-что на кого-что); 마차에 의무를 ~ нагружать телегу; 2. поручать; возлагать обязанность; 개인적 의무를 ~ возлагать на личную ответственность; 3. вытирать; стирать; 나는 그에 대해 눈물을 지우지 않을 것이다 Я о нём не заплачу.; 4. делать аборт; 그녀는 아이를 지웠다 Она сделала аборт.
신고	申告; подача сведений; сообщение; заявление; ~하다 подавать заявление; заявлять о ком-чем; сообщать кому о чём; докладывать; делать заявку; 세관 ~ таможенная декларация; 출생 ~ сообщение о рождении; ; 신고 辛苦; тяготы; лишения; невзгоды; ~하다 мучиться с кем-чем (над кем-чем); страдать от чего, за кого-что; испытывать мытарства; 그는 이 일로 ~를 겪었다 Он мучился над этой работой.
골목길	переулок
달아나다	бежать; мчаться; убегать; удирать; обращаться в бегство; миновать; исчезать; улетать; 감옥에서 ~ убегать из тюрьмы; 허겁지겁 ~ удрать в спешке; 단추가 달아났다 Пуговица оторвалась.; 입맛이 달아났다 Аппетит пропал.; 잠이 달아났다 Пропал сон.
검증	檢證; подтверждение; доказательство; ~하다 удостоверять подлинность; заверять
중상	重傷; тяжёлое (серьёзное) ранение (увечье); тяжёлая рана; ~을 입다 получать тяжёлое ранение; 총탄으로 ~을 입으 병사 боец, тяжелораненый пулей; 치명적인 ~을 입다 получать смертельное (тяжёлое) ранение
응급	應急; ~의 срочный; экстренный; временный; ~대책 срочные (экстренные) меры; ~수리 срочный ремонт; ~처치 первая (медицинская) помощь
치료	治療; лечение; терапия; ~하다 лечить
강도	强盜; грабитель; разбойник; гангстер; ~를 당하다 быть ограбленным
친숙	親熟; ~하다 хорошо знакомый; быть хорошо знакомым; быть близким; 서로 ~해지다 сблизиться
식전	食前; до завтрака; до еды; перед едой; натощак; ~에 약을 먹다 принимать лекарство натощак
원망	怨望; сетование на кого-что; жалоба на кого-что; ~하다 сетовать на кого-что; пенять кому за что; жаловаться на кого; ~스러운 얼굴 не довольное выражение лица
게다가	к тому же; вдобавок; более того; сверх того
말문	－門; рот; ~을 막다 зажать (заткнуть) рот; ~을 떼다(열다) открыть рот; заговорить; нить разговора
사납다	злой; свирепый; крутой; жестокий; страшный; отвратительный; 사나운 바다 разбушевавшееся море; 사나운 세상 жестокий мир
쟁반	錚盤; латунное блюдо; круглый латунный поднос
받쳐들다	нести, придерживая
빌다	1. желать; просить; молить; 행운을 ~ желать удачи; 2. занимать; заимствовать
건배	乾杯; тост; ~를 제의하다 предложить (провозгласить) тост
묵묵히	默默-; молчаливо; молча; не говоря ни слова
찌푸리다	хмурить (лицо; брови); морщить; насупиться; прищуривать (глаза); покрытый облаками; облачный; мрачный; хмуриться; 찌푸린 날씨 облачная погода; 얼굴을 찌푸리고 с хмурым лицом; 이마를 ~ нахмурить брови; 얼굴을 ~ сделать перекошенное лицо; сделать гримассу; 그는 아파서 얼굴을 찌푸렸다 Его лицо было перекошено от боли.
떨다	дрожать; трястись
새끼	1. молодая особь; детёныш; негодяй; сволочь; ребёнок; 한 배의 ~ помёт; выводок; ~까마귀 воронёнок; 2. соломенная верёвка
빨다	1. сосать; 젖을 ~ сосать грудь; 말상대자가 담배를 깊게 빨았다 Мой собеседник глубоко затянулся сигаретой.; 2. стирать; 옷을 ~ стирать одежду
설마	вряд ли; едва ли; авось; ~가 사람 잡는다 На "авось" не надейся.
겁	劫; будд. кальпа (санскр. kalpa); ; 겁 怯; страх; трусость; малодушие; ~결에 в испуге; ~이 많다 пугливый; боязливый; ~이 없다 бесстрашный; ~을 내다 бояться; испугаться; ~이 나다 бояться; ~을 먹다 струсить
진지	трапеза; ; 진지 眞摯; ~하다 искренний; ~하게 искренне; ; 진지 陣地; позиция; ~를 펴다 занимать позицию
더러	1. несколько; немного; незначительно; некоторая часть; некоторые; ~그렇게 이야기 하는 사람도 있다 Некоторые так говорят.; 2. кое-что; кое-кто; 3. иногда; временами; местами; 우리는 ~ 만나기도 한다 Мы иногда встречались.
흠칫	от испуга; от неожиданности; ~하다 вздрогнуть от испуга (неожиданности)
잠자코	молча; безмолвно
초조	焦燥; ~하다 беспокойный; тревожный
매만지다	приводить в порядок; приглаживать
새파랗다	тёмно-синий; 새파란 하늘 синее небо
질리다	1. надоесть кому; наскучить чем; 그 여자에게 질렸다 Она мне надоела.; 질리도록 보다 намозолить глаза кому; 혐오할 정도로 ~ набить оскомину; 질리도록 먹다 сыт по горло чем; 2. бледнеть; стать бледным; 무서워서 하얗게 질렸다 Лицо побледнело от страха.; 3. трусить перед кем-чем; 시험에서 ~ испытывать страх на экзамене
안절부절	~못하다 не находить себе места; беспокоиться; 시험을 앞두고 ~못하다 волноваться перед экзаменом
놓이다	быть отпущенным; быть освобождённым; успокаиваться; находиться; лежать (на чём); быть установленным; быть сооружённым; 기숙사 입구에 전화가 놓였다 У входа общежития установлен телефон.; 나는 지금 곤란한 처지에 놓여 있다 Сейчас я нахожусь в затруднительном положении.
선반	－盤; полка; токарный станок
전등불	電燈-; свет электрической лампочки
뜨다	1. подниматься; взлетать; открыть; раскрыть; всходить; плавать; плыть; парить; 2. покидать; оставлять; уезжать; уходить; 3. вязать; плести; аккуратно шить; 4. 각으로 ~ разделывать тушу; 포를 ~ мелко нарезать; 5. медленный; далёкий; отдалённый; нечувствительный
뚜렷이	отчетливо; ясно; четко; 그 사원은 하늘에서도 ~ 보였다. Храм был отчетливо виден с воздуха.; 그는 모든 것을 아주 ~ 기억할 수 있었다. Он мог помнить все очень отчетливо.
하마터면	чуть было не ...; едва не ...; ёле; едва ли не; ~ 죽을 뻔했다 чуть не погиб; еле спасся; 그는 ~ 넘어질 뻔했다 Он чуть было не упал.
우물거리다	кишмя кишеть; толпиться; ; 우물거리다 ; медленно жевать; шевелить губами
오직	только; лишь
묻히다	быть закрытым (закопанным, погребённым); находиться в недрах; погрязнуть (в чём-либо); ; 묻히다 ; намазывать; 가루를 ~ обваливать в муке
수첩	手帖; записная книжка; блокнот
적다	1. записывать; писать; 2. немногочисленный; небольшой; маленький
깨뜨리다	1. разбивать; ломать; 접시를 ~ разбить тарелку; 2. нарушать; срывать; подрывать; 가정의 행복을 ~ разрушать семейное счастье; 기록을 ~ побить рекорд; 평화를 ~ нарушать мир
재촉	~하다 требовать; побуждать; торопить; подгонять
떼밀다	толкать всем телом
내쫓다	выгонять; изгонять; 직장에서 ~ выгонять со службы; 집에서 ~ выгонять из дома; 내쫓기다 быть выгнанным
사과주	沙果酒; яблочная наливка
겉면	-面; внешняя сторона
공포	公布; обнародование; официальное объявление; опубликование; ~하다 обнародовать; официально объявлять; опубликовывать; ; 공포 恐怖; страх; боязнь; ~ 정치 политика запугивания; ; 공포 空砲; холостой выстрел; ~ 사격 холостой выстрел; = 헛총
헐떡이다	loose(-fitting); baggy;
꼴	1. вид; картина; зрелище; 이런 ~로 в таком виде; ~불견이다 неприятно (отвратительно) смотреть; ~사납다 отвратительный; мерзкий; 2. скошенная трава; корм; фураж; сено
개새끼	щенок; (перен.) подлец
어느새	незаметно; как-то; уже
눈초리	взгляд; взор
앓다	болеть чем; быть больным; 앓는소리 стон; недовольство; жалоба; 앓던 이가 빠진 것 같다 Будто камень с сердца свалился.
모조리	всё; целиком; полностью
작정	作定; решение; намерение; ~하다 решаться; намереваться
축	~ 늘어지다 свисать; ~ 쳐지다 опустить; ; 축 縮; ~(이) 가다 съёжиться; осунуться; ~(이) 나다 не хватать; недоставать; ~(이) 지다 потерять авторитет; выдыхаться; ослабевать; худеть; ; 축 軸; ось; центральный стержень
아랫도리	1. нижняя часть туловища (тела); 2. брюки; штаны; юбка
낙서	落書; мазня на бумаге; надпись; неразборчивый почерк; ~하다 марать бумагу; небрежно писать; 벽에 ~하다 написать на стене оскорбительные слова
불쌍	~하다 жалкий, несчастный; 그의 처지가 ~ Его положение жалко.; ~하게 여기다 жалеть; ~한 처지 жалкое положение
살짝	слегка; незаметно; тайком; ~ 도망가다 незаметно убегать
눈짓	подмигивание
딴전	~을 부리다 заниматься посторонним делом; говорить на постороннюю тему
부리다	заставлять работать; водить (напр, машину); править (напр, лошадью); проявлять (какие-л. качества); 많은 사람을 ~ заставлять работать много людей; 재주를 ~ показывать фокусы; 요술을 ~ колдовать; 고집을 ~ упрямиться
귀엣말	귓속
지문	地文; элементы рельефа; ~항법 определение местонахождения по элементам рельефа; ; 지문 指紋; отпечатки пальцев; ~을 찍다 прикладывать палец; ~을 채취하다 снимать отпечатки пальцев; ~을 남기다 оставлять свои отпечатки пальцев; ~감정법 дактилоскопия; ~채취 снятие отпечатков пальцев; ; 지문 誌文; сведения об умершем и месте его захоронения
하찮다	неважный; нехороший; незначительный; несущественный; мелкий; ничтожный; 하찮은 일 пустяковое дело; 하찮은 일에 성내다 сердиться на пустяковое дело (по пустякам)
짓다	делать; создавать; приготовлять; устанавливать (связь; отношения); 옷을 ~ шить одежду; 집을 ~ строить дом; 밥을 ~ варить рис (на пару); 시를 ~ слагать стихи; 이름을 ~ давать имя; 한숨을 ~ вздохнуть; 웃음을 ~ улыбаться; 눈물을 ~ заплакать; 무리를 ~ собирать толпу (в стаю); 대오를 ~ строиться в ряды; 죄를 ~ совершать преступление
포장	包裝; упаковка; ~하다 упаковывать; ~하는 사람 упаковщик; ; 포장 鋪裝; мощение; покрытие; ~하다 мостить; покрывать; 콘크리트 ~ бетонированное покрытие; бетонированная дорожка
한구석	угол; захолустье; глушь; 방 ~에 в одном углу комнаты
장사	торговля; купля-продажа; ~하다 торговать; ; 장사 壯士; удалой молодец; богатырь; ; 장사 葬事; похороны; погребение; кремация; ~를 지내다 хоронить; погребать; ; 장사 長蛇; большая змея
지장	指章; отпечаток пальца; ~을 찍다 ставить отпечатки пальцев; ; 지장 支障; препятствие; помеха; проблема; вред; ущерб; неудобство; ~을 주다 мешать; препятствовать; 일을 하는데 아무런 ~이 없다 В работе нет никаких препятствий.; ; 지장 智將; находчивый генерал; мудрый полководец
늘어놓다	разбрасывать; раскидывать; распространяться; наплетать; 말도 안되는 소리를 ~ наплести чепуху; 온 방안에 온갖 잡동사니를 ~ разбросать всё (всякую всячину) по всей комнате
착수	着手; начало; ~하다 начинать; браться за дело; приступать к работе; предпринимать что; приниматься за дело; вставать (вступать) на путь чего; пускаться во что; 우리는 서둘러 일에 ~해야만한다 Мы должны немедленно приступить к работе.
흥분	興奮; волнение; возбуждение; раздражение; ~하다 быть в возбуждении; быть возбуждённым; волноваться; возбуждаться; раздражаться; ~시키다 волновать; возбуждать; раздражать; ~하여 в возбуждении; возбуждённо; взволнованно
점원	店員; продавец; продавщица; клерк
덜거덕거리다	clatter; rattle; crackle.
투덜대다	투덜거리다
골치	голова; ~ 아픈 일 источник беспокойства; проблема; тревога; ~를 앓다 беспокоиться о ком-чём; мучиться с кем-чем {над кем-чем)
묵다	быть старым; отдыхать; находиться под паром; 묵은 솜 старая вата; 묵은 밭 залежные суходольные земли; ; 묵다 ; ночевать; останавливаться
마디	узел; колено; сустав; сочленение; сегмент; слово; фраза; куплет; такт; 뼈~ сочленение костей; 한 ~도 ни (одного) слова
체하다	滯－; страдать несварением желудка
단조롭다	單調-; монотонный, однообразный; 단조로움 монотонность, однообразие; 단조로운 경치 однообразный пейзаж; 단조로이 монотонно, однообразно
뒤섞이다	быть перемешанным (перепутанным; перетасованным); 책이 모두 뒤섞여졌다 Все книги перемешались.
무적	無敵; непобедимый; не имеющий себе равных; ~의 군대 непобедимая армия; ~ 함대 непобедимая армада
끼다	1. заволакиваться; садиться; покрываться чем; зарастать; появляться на лице; звучать голосе; 그녀의 얼굴에 수심이 끼었다 У неё на лице лежит тень.; 책상에 때가 끼었다 Стол покрыт грязью.; 하늘에 먹구름이 끼었다 Небо заволокло тучами.; 2. вставлять; вкладывать; помещать; надевать; омывать; прибегать к помощи; использовать в своих интересах; дополнять; добавлять; присоединять; 결혼반지를 손가락에 ~ надевать обручальное кольцо на палец; 모스크바 시는 강을 끼고 있다 город Москву омывает река; 창틀에 유리를 ~ вставить стекло в оконную раму
뱃고동	пароходный гудок
치우다	убирать; приводить в порядок; прибирать; доедать; съедать до конца; бросать (остаапять) на середине; 먹어 ~ съесть
빈혈	貧血; малокровие; анемия
풍만	豊滿; ~하다 богатый; обильный; полный; пухлый; округлый; ~한 고장 благодатный край; 가슴이 ~한 여인 полногрудая женщина
몸매	телосложение; фигура
끌어당기다	притягивать; тянуть
노릇	роль; функция; занятие; работа; жалкое (бедное) положение; 목수 ~을 하다 работать столяром, ; 주인 ~을 하다 хозяйничать; 저런 딱한 ~이 있나 Какая беда (бедствие)!; 참 교육자 ~을 하기란 쉽지 않은 일이다. Быть настоящим педагогом - нелёгкое дело.
고아	孤兒; сирота; ~가 되다 осиротеть; ~생활 сиротская жизнь; ; 고아 高雅; ~하다 изящный; изысканный; элегантный
선원	禪院; = 선방(禪房); ; 선원 船員; экипаж (судна); член экипажа
조난	遭難; авария; бедствие; беда; столкновение; катастрофа; кораблекрушение; ~당하다 терпеть аварию (бедствие); ~구조대 аварийная служба; ~기금 вспомогательный капитал; ~현장 место аварии
쓸쓸	~하다 хмурый; угрюмый; грустный; 쓸쓸한 생각 грустные думы
못살다	жить бедно (трудно); 못살게 надоедливо; 못살게 굴다 тормошить
굴다	굴다 [학대하다] persecute; oppress; torment; be hard (up) on <a person>; be cruel to <a dog>;кем-либо плохо.
찾아오다	приходить; приходить с визитом; посещать; навещать; получать обратно; 작업상의 일로 ~ заставать за работой
모호	模糊; ~하다 неясный; неопределённый; туманный; ~한 대답 расплывчатый ответ; ~하게 하다 придавать неопределённый характер (чему); наводить тень (на ясный день)
띄우다	1. отправлять; 2. оставлять промежуток (расстояние)
험담	險談; злословие; пересуды; ~하다 злословить; отзываться о ком; пересуживать
이를테면	допустим; к примеру; скажем; так сказать
시중	ухаживание; уход; ~하다 (들다) ухаживать; прислуживать; ~을 받다 быть под присмотром кого; 그녀는 환자들을 잘 ~든다 Она хорошо ухаживает за больными.; 한자 ~ уход за больным; ; 시중 市中; город; ~ 은행 городской банк
묻다	зарывать; закапывать; погребать; скрывать; таить в душе; прятать; 어머니의 가슴에 얼굴을 уткнуться лицом в грудь матери; спрятать лицо на груди матери; ; 묻다 ; приставать; прилипать; 기름이 ~ замаслиться; ; 묻다 ; спрашивать; расследовать; вести следствие; 길을 ~ спросить, как пройти; узнавать дорогу; 책임을 ~ привлекать к ответственности
헐떡거리다	задыхаться; 그는 숨이 차서 헐떡거리며 왔다 Он шёл тяжело дыша.
겨우	едва; еле; с трудом; ~~ едва-едва; ~ 두 사람 남았다 Осталось лишь два человека.; ~ 살아가다 перебиваться; ~ 열차 시간에 댔다 Едва успел на поезд.
노리다	замышлять; задумывать; выжидать; метить в кого(что; куда) ; 기회를 ~ выжидать удобный случай; 자리를 ~ метить в начачьники; 복수를 ~ замышлять месть
구둣발	следы ботинок
자국	1. след; ~을 밟다 идти по следу; 2. шрам; ; 자국 自國; своя страна; родина; ~의 родной; отечественный
그치다	прекращать(ся); приостанавливать(ся); кончать(ся); переставать; ограничиваться; 그칠 사이 없이 непрестанно; ни на минуту не переставая; 그칠 줄 모르다 безудержный; 그칠 줄 모르는 박수소리 не смолкающие аплодисменты; 비가 그쳤다 Дождь перестал идти.; 말을 ~ перестать говорить; 그침 прекращение; приостановление; ограничение
뒤덮다	сплошь покрывать; 안개가 숲을 뒤덮었다 Туман окутал рощу.
빙그레	~ 웃다 мило улыбаться
감식	減食; ~하다 снижать рацион питания; ; 감식 鑑識; ~하다 оценивать; судить, разбираться; 지문감식 дактилоскопия
뜻밖	неожиданно
뿌리치다	стряхивать; 유혹을 ~ стряхнуть с себя соблазны
움츠리다	быстро сжимать; 몸을~ съёжиться
가엾다	жалкий; несчастный; бедненький; ничтожный; 가엾게 여기다 жалеть; сжалиться (над кем-л.); 가엾은 고아 несчастный сирота; 가엾기도 하다 какая жалость!
처녀	處女; девушка; девственница; незамужняя; дева; ~의 девичий; девический; ~다운 скромная; застенчивая; ~가 아이를 낳아도 할 말은 있다 Всему своя причина.; ~공연 дебют; ~ 생식 партеногенез; девственное размножение; ~시절 девичество; 노~ старая дева; 숫~ девственница
난처	難處; ~하다 затруднительный; 난처하게 되다 оказываться в затруднительном (неловком) положении; попадать впросак; 난처해 하다 чувствовать себя неловко; смущаться; испытывать конфуз
빠뜨리다	подвергать; терять; пропускать; 곤란한 입장에 ~ подвергать трудному положению; 한 줄을 ~ пропускать одну строку; 지갑을 ~ терять кошелёк
자아	自我; сам; собственное "Я"; ~의식 самосознание
정직	停職; временное отстранение от службы; ; 정직 正直; честность; чистосердечие; ~하다 честный; чистосердечный
맹세	←盟誓; клятва; ~하다давать клятву
파르르	~ 떨다 трепетать; дрожать; ~ 성을 내다 внезапно вспылить; 눈꺼풀이 ~ 떨린다 веки дрожат
윽박지르다	угрожать кому чем; запугивать кого
슬리퍼	slippers; комнатные туфли; тапочки
머플러	англ. muffler; 1. кашне; шарф; 2. глушитель; звукопоглощающее устройство; звукопоглощающее приспособление; шумоглушитель
초췌	憔悴; ~하다 изнурённый; измождённый; зачахший; ~하다 чахнуть
엉망진창	путаница; беспорядок;
헝클어지다	спутываться; перепутываться; запутываться; взлохматиться; осложняться
증세	症勢; = 증상
쏠리다	склоняться; накрениться; сползать; устремляться в одну сторону; увлекаться чем; 모든 시선이 그에게 쏠렸다 Все глаза устремились на него.
윽박지르다	угрожать кому чем; запугивать кого
슬리퍼	slippers; комнатные туфли; тапочки
머플러	англ. muffler; 1. кашне; шарф; 2. глушитель; звукопоглощающее устройство; звукопоглощающее приспособление; шумоглушитель
초췌	憔悴; ~하다 изнурённый; измождённый; зачахший; ~하다 чахнуть
엉망진창	путаница; беспорядок;
헝클어지다	спутываться; перепутываться; запутываться; взлохматиться; осложняться
증세	症勢; = 증상
쏠리다	склоняться; накрениться; сползать; устремляться в одну сторону; увлекаться чем; 모든 시선이 그에게 쏠렸다 Все глаза устремились на него.
설레설레	(머리를) ~ 흔들다 покачивать (головой)
들르다	заходить; заезжать; заглядывать; 상점에 ~ зайти в магазин
벌떡	внезапно; ~ 일어나다 внезапно вставать
핏기	－氣; цвет крови; 이 소식을 듣자 그녀의 얼굴에서 ~가 가셨다 Она побледнела, когда услышала это известие.
부들부들	tremblingly; quiveringly;
짖다	лаять; каркать (о вороне); трещать (о сороке)
병자	病者; больной; ~에게는 황금의 침대도 기쁘지 않다 Больной золотой кровати не рад.
짓	движение; жест; поступок; поведение; 바보같은 ~을 하다 делать глупости; 비열한 ~ подлый поступок; 위험한 ~을 하다 играть в опасную игру; 고개~ движение головой (кивок)
따위	подобный чему-либо; типа чего-либо; 너 ~ такие как ты, ты и тебе подобные
쐬다	вдыхать; дышать; выходить на свежий воздух; 신선한 공기를 ~ вдыхать свежий воздух
걸음	шаг; темп; походка; поступь; 한~ 한~ шаг за шагом, поэтапно; ~~ шаг за шагом; каждый шаг; ~을 재촉하다 (늦추다) ускорять (замедлять) шаг; 바쁜 ~ торопливый шаг; ~이 바쁘다 (느리다) ходить быстрым (медленным) шагом; ~을 걷다 шагать; ~을 멈추다 остановиться; ~을 서두르다 торопиться; ~을 내딛다 делать шаг вперёд; 한~ 물러서다 отступать на шаг; 한~도 물러서지 않다 ни на шаг (ни шагу) не отступать; 한 ~ 앞으로 шаг вперёд; 두 ~ 뒤로 два шага назад; ~아 날 살려 라 Давай бог ноги; ~짐작 измерение расстояния шагами
뒤쫓다	преследовать; следовать (за кем); идти вслед (по пятам)
으쓱	1. ~하다 ёжиться; 2. ~하다 важничать; кичиться; чваниться; быть в приподнятом настроении
버릇	привычка; дурная привычка; дурные наклонности; правила поведения; ~없다 невоспитанный; непочтительный; нетактичный; неприличный; неучтивый
바위	скала; большой камень; валун; ~가 많은 скалистый
거닐다	прогуливаться; бродить; 숲속을 ~ бродить по лесу; 공원을 ~ прогуливаться по парку
방파제	防波堤; волнолом; волнорез; брекватер; мол
펼치다	раскрывать(ся); развёртывать(ся); расстилать(ся); 주먹을 ~ разжимать кулак; 깃발을 ~ развёртывать знамя; 날개를 ~ расправлять крылья; 눈 앞에 광활한 벌판이 펼쳐졌다 Перед глазами расстилаются необозримые поля.
당당	堂堂; ~하다 достойный; гордый; величественный; внушительный; ~히 гордо; с достоинством; по-праву; ~한 권리 законные права; ~한 위세 внушительный вид; 세력이 ~하다 иметь большое влияние (большую власть)
해초	海草; морские водоросли
뒤덮이다	быть сплошь покрытым
모래밭	песчаные берега; песчаная равнина
분양	分讓; раздача; распределение; 주택~ распределение домов; 아파트 ~ распределение квартир
공터	空－; свободное (пустое) место; = 공지(空地)
건축	建築; строительство; сооружение; возведение; застройка; ~하다 строить; сооружать; возводить; застраивать; ~용의 строительный; предназначенный для строительства; ~공사 строительные работы; ~공학 технология строительства; ~기사 инженер-строитель; ~면적 площадь застройки; ~ 사무소 строительная контора; ~양식 архитектурный стиль; ~업자 строитель; ~ 재료 строительные материалы; стройматериалы; ~ 현장감독 прораб
미완성	未完成; незаконченный; незавершённый; несложившийся; ~품 полуфабрикат
중지	中指; средний палец; ; 중지 中止; приостановка; прекращение; перерыв; отмена; ~하다 приостанавливать; прекращать; прерывать; отменять; ; 중지 衆智; народная мудрость
팽개치다	выкидывать; выбрасывать; оставлять; бросать
인적	人的; человеческий; людской; ~손실 человеческие жертвы; ~자원 людские ресурсы; ; 인적 人跡; следы человека; признаки присутствия человека; ~이 끊어진 밤거리 безлюдная ночная улица
수색	搜索; обыск; разведка; поиск; ~의 обыскной; разведочный; ~하다 обыскивать; разведывать; проводить, поиск; 가택 ~하다 подвергнуть обыску; 그의 아파트에서 가택 ~이 있었다 В его квартире был произведён обыск.; 새벽에 우리는 ~을 하기 위해 출발했다 На рассвете мы отправились на разведку.
영장	令狀; письменное распоряжение (приказ); ~을 발부하다 давать ордер; 소환장 судебная повестка; 체포~ ордер на арест; ; 영장 靈長; венец творения; царь природы; 인간은 만몰의 ~ 이다 Человек - царь природы.
침입	侵入; проникновение; вторжение; ~하다 проникать; вторгаться; захватывать; оккупировать
선명	鮮明; ~하다 ясный; отчётливый; чёткий; ~도 яркость (цвета); ~성 яркость
성큼성큼	~걷다 ходить подпрыгивающей походкой
양탄자	洋－; ковёр; ковровый; ...에 ~를 깔다 устилать что ковром; покрывать что ковром; ~를 깐 듯한 푸른 초원 зелёный ковёр луга; ~ 제조공장 ковровая фабрика
흙투성이	быть выпачканным (измазанным) грязью
웅장	雄壯; ~하다 величественный; грандиозный
장식	裝飾; украшение; декорирование; ~적 декоративный; ~하다 украшать; декорировать; разукрашивать; ~되다 украшаться; декорироваться; разукрашиваться; 실내~ внутреннее убранство; оформление интерьера; ~미술 декоративная живопись
풍경화	風景畵; пейзаж; пейзажная живопись; ~가 пейзажист
책장	冊張; листы книги; страницы; ~을 넘기다 перелистывать книгу; ; 책장 冊欌; книжный шкаф; этажерка
멋지다	весьма привлекательный (модный)
성큼성큼	~걷다 ходить подпрыгивающей походкой
양탄자	洋－; ковёр; ковровый; ...에 ~를 깔다 устилать что ковром; покрывать что ковром; ~를 깐 듯한 푸른 초원 зелёный ковёр луга; ~ 제조공장 ковровая фабрика
흙투성이	быть выпачканным (измазанным) грязью
웅장	雄壯; ~하다 величественный; грандиозный
장식	裝飾; украшение; декорирование; ~적 декоративный; ~하다 украшать; декорировать; разукрашивать; ~되다 украшаться; декорироваться; разукрашиваться; 실내~ внутреннее убранство; оформление интерьера; ~미술 декоративная живопись
풍경화	風景畵; пейзаж; пейзажная живопись; ~가 пейзажист
책장	冊張; листы книги; страницы; ~을 넘기다 перелистывать книгу; ; 책장 冊欌; книжный шкаф; этажерка
멋지다	весьма привлекательный (модный)
억지로	насильно; силой
어지럽다	кружиться; идти кругом; беспорядочный; хаотический; 머리가 ~ испытывать головокружение; 어지러운 세상 смутные времена
흩어지다	рассеиваться; разлетаться; расходиться; рассыпаться; разбрасываться; разваливаться; разлучаться; разбредаться
따다	1. рвать; срывать; собирать; 2. брать; 3. вскрывать, открывать; 요점을 ~ конспектировать; 점수를 ~ набирать очки; получать отметку; 깡통을 ~ открывать консервную банку
찌꺼기	вытопки; осадок; отбросы; подонки; остаток; 타고남은 ~ зола; 음식 ~ остатки пищи; 커피 ~ кофейная гуща
더러워지다	запачкаться
지저분	~하다 грязный; неряшливый; 방안이 ~하다 в комнате беспорядок; ~한 셔츠 грязная рубашка; ~한 거리 грязная улица
어리둥절	~하다 быть растерянным (смущённым); смущаться; спутываться
실마리	начало нитки; ключ; (путеводная) нить; 문제 해결의 ~를 찾다 найти ключ к разрешению вопроса; 실 타래에서 ~를 찾다 найти начало нитки в клубке; 이야기의 ~ нить разговора
행방불명	行方不明; ~되다 без вести пропасть; ~자 пропавший без вести
헤어지다	1. расставаться с кем; разлучаться с кем; расходиться; разводиться с кем; прощаться с кем-чем; 2. рассыпаться; высыпаться; 3. трескаться
석고상	石膏像; статуя из гипса
굳어지다	затвердевать; быть твёрдым
특종	特種; особый род (вид; сорт); особая порода; сенсационная новость; ~으로 다른 신문을 앞지르다 опубликовать сенсационное сообщение раньше других газет
표제	標題-表題; название; заглавие; тема сочинения на экзамене; ...라는 ~의 소설 роман под названием ...; ~를 붙이다 дать название; ~ 음악 музыкальное произведение, посвященное чему
활자	活字; типографский шрифт; литера; ~를 맞추어 판을 짜다 набирать; составлять набор; ~를 줍다 набирать; подбирать литеры
행방	行方; местонахождение; ~을 감추다 заметать следы; скрываться; сбиваться со следа; исчезать; ~을 알아맞추다 найти кого
뒷좌석	заднее сидение
핏자국	пятно крови; кровавое пятно
차례	次例; порядок; последовательность; ряд; очередь; раз; случай; оглавление; содержание; ~로 по порядку; поодиночке; поочерёдно; попеременно; по очереди; следовательно; вслед за; сразу же; ~를 기다리다 ожидать свою очередь; ~가 돌아오다 стоять на (в) очереди; ~가 뒤바뀌다 не в порядке; испорченный; 나의 뒷 ~다 очередь за мной; 서두에 있는 ~ оглавление находится в начале книги; ; 차례 茶禮; упрощённый обряд жертвоприношения, совершаемый по праздникам
팔리다	быть проданньш; быть очарованным; быть обращенным (направленным); быть использованным; быть известным (популярным); 돈 몇 푼에 ~ продать (себя) за гроши; 그는 그녀에게 넋이 팔려 있다 Он ею очарован.; 술꾼으로 얼굴이 팔린 사람 человек, известный как пьяница
목청	тембр голоса; голос; голосовые связки; ~이 터지도록 부르다 кричать, что есть мочи; ~을 돋우다 напрягать голос
회오리바람	вихрь
떠들다	шуметь; кричать; поднимать шум; разноситься
분전	奮戰; жестокая борьба; 끝까지 ~하다가 목숨을 버리다 отдать жизнь жестоко сражаясь до конца
방귀	газы; ~ 냄새가 지독하다 Запах газов противен.; ~를 뀌다 испускать газы; навонять
뀌다	вонять чем; испускать газы; 방귀를 ~ освобождаться от газов
딱	полностью; совсем; прочно; крепко; плотно; как раз; точно; широко; сильно
대꾸	1.ответ; 2.возражение; ~하다 1.отвечать; 2. возражать; пререкаться
취재	取才; сбор материала (информации); подготовка репортажа; ~하다 собирать (отбирать) материал (информацию; данные); освещать в прессе; вести (готовить) репортаж; ~길에 오르다 отправиться, чтобы подготовить (провести) репортаж; ~ 기자 репортёр; ~ 활동 журналистская (корреспондентская; репортёрская) деятельность; освещение в печати
발사	發射; выстрел; стрельба; пальба; запуск; ~하다 стрелять; палить; вести огонь; запускать; 로켓을 ~하다 запускать ракету; ~장치 пусковая установка
탄환	彈丸
명중	命中; попадание в цель; ~하다 попадать (прямо) в цель; ~ 사격 меткая стрельба
파견	派遣; посылка; командировка; ~하다 посылать; командировать; отправлять; 사건 조사에 ~하다 командировать на расследование дела
강변	强辯; софистика; казуистика; ~하다 заниматься софистикой (казуистикой); ; 강변 江邊; = 강가; ~ 도로 дорога по берегу реки
벌어지다	образовываться (о ели); развертеться; расходиться; расширяться
짐작	斟酌; догадка; ~하다 догадываться; предполагать; ~하건대 вероятно
잇달다	следовать один за другим; 잇달아서 непрерывно, все время; последовательно; 10시간 잇달아 на протяжении 10 часов; 잇달아 3회 이기다 выиграть 3 раза подряд; 불행이 잇달다 постоянные неудачи; 밤은 낮에 ~ За ночью следует день.
괴기	怪奇; причудливый; ~소설(영화) сенсационная книга (фильм)
출현	出現; появление; проявление; ~하다 появляться; прояапяться; являться
임자	владелец; хозяин; 집~ владелец (хозяин) дома
드러내다	обнаруживать; выявлять; проявлять; показывать; обнажать; выражать; 대단한 재능을 ~ обнаружить большие способности
정체	停滯; застой; застойный; ~하다 быть застойным; ; 정체 政體; режим; форма правления; 공화~ республиканская форма правления; 입헌~ конституционная форма правления; ; 정체 正體; подлинный характер; истинное лицо; ~를 밝히다 показать истинное лицо; сорвать маску с кого
부랑	浮浪; бродяжничество; ~하다 бродяжничать
지체	происхождение; род; ~가 높다 высокое происхождение; ; 지체 肢體; конечности; ~가 부자유한 хромой; повреждённый; ~장애인 инвалид; калека; ; 지체 遲滯; задержка; приостановка; откладывание; отсрочка; ~하다 задерживать; отсрочивать; откладывать; ~없이 сразу же; незамедлительно
태세	態勢; состояние; положение; позиция; готовность; ~를 갖추다 быть готовым к чему; 반격 ~ готовность к контрнаступлению
미사	лат. messa; месса
몰다	гнать; сгонять; загонять; отгонять; отпугивать; управлять; водить; преследовать; направлять; поворачивать; ругать; поносить; ...로 ~ считать (рассматривать; обращаться) как ...; 죄인으로 ~ считать преступником
호기심	好奇心; любопытство; ~이 많은 любопытный
짜증	недовольство; раздражительность; ~나다 досадный; нервный; раздражительный; ~나게 하다 действовать на нервы колу; нервировать; дёргать; ~내다 раздражаться; нервничать; 하찮은 일로 ~내다 раздражаться из-за пустяков; ~스럽게 머리를 젓다 недовольно качать (встряхивать) головой
조간	朝刊; утренний выпуск; ~ 신문 утренняя газета
인쇄	印刷; печатание; ~하다 печатать; 그 책은 아직 ~중에 있다 Эта книга все ещё в печати
봉투	封套; конверт; ~를 붙이다 заклеить (запечатать) конверт; ~를 열다 распечатать конверт; ~에 우표를 붙이다 наклеить марку на конверт
투서	投書; анонимное письмо; ~하다 писать и посылать анонимное письмо
싣다	грузить что чем; перевозить; транспортировать; помещать; пускать воду на рисовое поле; содержать в себе; нести с собой; 기차에 집을 ~ грузить товары в вагон; 봄 바람이 꽃 향기를 실어온다 Весенний ветер несёт с собой душистый запах цветов; 배에 짐을 ~ грузить корабль товарами; 신문에 광고를 ~ поместить объявление в газету; 잡지에 기사를 ~ поместить статью в журнал
내던지다	выбрасывать; выкидывать; вышвыривать; забрасывать; бросаться словами; 시작한 일을 ~ забросить начатое дело; 창밖으로 담배꽁초를 ~ выбрасывать окурок за окно
자물쇠	замок; ~를 잠그다 запирать на замок; 문을 ~로 잠그다 заперёть дверь на замок
어귀	вход; въезд; начало; 강~ устье реки; ; 어귀 語句; = 어구(語句)
드물다	редкий
해군	海軍; военно-морские силы; военно-морской флот; ~의 военно-морской; ~기지 военно-морская база
조선소	造船所; судоверфь; судострежтельная верфь
건조	乾燥; сушка; сушение; ~하다 сухой; скучный; сушить; высушивать; 무미~하다 сухой; скучный; ~ 소독 дезинфекция (дегазация) высушиванием; ; 건조 建造; строительство (судов); ~하다 строить (конструировать) суда; 선박~ судостроение
썩다	гнить; портиться; не использоваться; лежать мёртвым грузом; зарывать; тяжело на душе; 썩은 냄새 гнилой (гнилостный) запах; 썩은 물 гнилая вода; 건초가 비에 젖어 썩고 있다 Сено гниёт под дождём.; 생선이 썩었다 рыба испортилась; 시체가 썩고 있다 Труп гниёт.; 재능을 썩히다 зарывать талант в землю
돌다리	каменный мост
소형차	小型車
둘러싸다	окутывать; обматывать; обволакивать; окружать; обступать; 둘러싸고 вокруг кого-чего
꾼	man occupied with
수군거리다	шептать(ся); шушукаться
헤치다	1. разбрасывать; раскидывать; раздвигать; рассеивать; 2. развязывать; распаковывать; распахивать; 3. преодолевать; 가시덤불을 헤치고 나아가다 пробиваться сквозь колючие заросли
열어젖히다	벌컥 열다
창의	創意; творческий замысел; инициатива; оригинальная мысль; ~적인 творческий; оригинальный
조각조각	in (broken) pieces; all to pieces
정원	定員; штат; кворум; ; 정원 庭園; двор и цветник
딸리다	be attached[annexed] to; belong to;
아담	雅淡; ~하다 благородный; элегантный; красивый; удобный
초인	超人; сверхчеловек; сверхчеловеческий
맞아들이다	receive; invite[ask] <a person> in;
야무지다	крепкий; сильный; стойкий
잠자리	1. стрекоза; 2. постель; ~에 눕다 ложиться в постель; ~를 걷다 убирать постель
불길	пламя, языки пламени; ~이 일다 воспламеняться; ~잡다 тушить огонь; 분노의 ~ пламя гнева; 정념의 ~ пламя страсти; ; 불길 不吉; несчастье, бедствие
양반	兩班; дворянин; дворянский; джентельмен
뛰다	прыгать; подпрыгивать; подскакивать; скакать; колотиться; быстро бежать
사살	射殺; расстрел; ~하다 расстрелять; 우리를 탈출한 호랑이를 ~했다 Мы подстрелили убежавшего от нас тигра.
즐기다	любить; увлекаться чем; наслаждаться чем; веселиться; хорошо проводить время; радоваться; 기회가 있는 동안 순간을 ~ наслаждаться пока есть возможность
말투	－套; манера говорить; интонация; акцент
인내심	忍耐心; терпеливость; ~이 강하다 очень терпеливый
꽂다	втыкать; всовывать; вставлять; ввинчивать; 바늘을 ~ втыкать иголку во что-либо; 전구를 소켓에 ~ ввинчивать лампочку в патрон
호통	злобный (сердитый) окрик; злобная ругань; ~치다 громко (зло) ругаться; сердито кричать; выкрикивать угрозы; громко окликнуть
거덜나다	разоряться; приходить в упадок; терпеть крах
가로막다	мешать; препятствовать; устраивать обструкцию; быть помехой
부름	призыв; зов
난리	亂離; 1. война; бунт; мятеж; смута; беспорядки; 2. беспорядок; хаос; ~를 평정하다 подавлять беспорядки; 방안이 ~법석이다 Комната в большом беспорядке.
지치다	1. усталый; утомлённый; 그는 죽도록 지쳐 있다 Он устал до смерти.; 나는 시종일관 똑같은 일만 하는데 지쳤다 Мне надоело делать всё время одно и то же.; 나는 서있기에 지쳤다 Я устал стоять.; 2. скользить по льду
친밀감	親密感; чувство большой дружбы; тесная дружба
엉뚱	~하다 необычайный; необычный; непомерный; странный; своеобразный; экстравагантный
하여금	그 사람으로 ~ 가게 하시오 Заставьте его пойти.; 나로 ~ 기다리게 하지 마시오 Не заставляйте меня ждать.
공포심	恐怖心; боязнь
어쨌든	во всяком случае; так или иначе
수상	受賞; ~하다 получать награду; ~ 위원회 жюри; ; 수상 殊常; ~하다 сомнительный; подозрительный; ~스럽다 казаться сомнительным (подозрительным); ; 수상 水上; на воде; над водой; ~경기 соревнования на воде; ; 수상 首相; премьер-министр; 내각 ~ председатель кабинета министров
체포	逮捕; арест; задержание; ~하다 арестовывать; задерживать
면직	免職; ~하다 отстранять от должности
침착	沈着; хладнокровие; самообладание; невозмутимость; ~하다 хладнокровный; невозмутимый; спокойный; уравновешенный
파내다	выкапывать; 감자를 ~ выкапывать картофель
파면	罷免; увольнение; ~하다 увольнять; снимать кого с должности; освободить кого от должности (со службы)
가만	1. молча; потихоньку; тайно; украдкой; втихомолку; неподвижно; спокойно; до сих пор; по-прежнему; 2. не шуметь; замолчите; не шумите; ~, 누가 온다 Тихо! Кто-то идет!
깡통	1. пустая банка; 2. пустой человек; глупец; невежда; 통조림 ~ пустая консервная банка; ~ 을 차다 стать нищим; 그는 음악에는 ~ 이다 Он полный профан в музыке.
석고	石膏; гипс; ~붕대 гипсовая повязка; ~조각 скульптура из гипса
사교가	общительный man
토지	土地; земля; земельный; ~ 개량 мелиорация; ~ 개혁 земельная реформа; ~ 국유화 национализация земли; ~ 대장 земельный кадастр; ~ 이용 землепользование; ~ 조사 обследование земель
부실	不實; ~하다 нездоровый; неустойчивый; нестойкий; ненадёжный; нечестный; неполный; недостаточный; бедный (о жизни); 몸이 ~하다 тело нездоровое; ~ 공사 фальшивая работа
소유자	所有者; владелец; собственник
귀족	貴族; аристократ; аристократия; ~적 аристократический; аристократичный; ~적으로 аристократически; аристократично; ~화되다 превращаться в аристократов; ~계급 аристократия; ~성 аристократичность; ~정치 аристократия; 노동~ рабочая аристократия
후손	後孫; потомки
제조	製造; изготовление; производство; ~하다 изготовлять; производить; делать из чего; вырабатывать; 한국에서 ~된 изготовлено (сделано) в Корее; товар корейского изготовления; 펄프로 종이를 ~하다 делать бумагу из бумажной массы; ~수단 средства производства; ~시설 производственные мощности; ~원가 фабричная цена; заводская себестоимость; 주문~ изготовление заказа; на заказ
유산	乳酸; выкидыш; преждевременные роды; аборт; ~하다 выкинуть (ребёнка); сделать выкидыш; ~ 되다 не удаваться; не сбываться; потерпеть неудачу; ; 유산 遺産; наследие; наследство; ~ 상속인 наследник; 문화 ~ культурное наследие
지배인	支配人; заведующий; распорядитель; менеджер
붉히다	делать красным; румянить; 얼굴을 ~ румянить лицо
싸구려	дешёвые вещи низкого качества
달리	иначе; по-другому; по-разному; ~하다 расходиться в чём; ...와 ~ иначе чем; в отличие от кого-чего; ~ 방법이 없다 Иначе нельзя.; 우리는 그들과 의견을 ~했다 Мы с ними разошлись во мнениях.
박히다	быть забитым (вбитым); быть воткнутым; быть напечатанным; быть снятым (сфотографированным); быть устремлённым
접근	接近; приближение; подход; подступ; ~하다 приближаться к кому-чему; подходить к кому-чему; сближаться с кем-чем
미처	ещё не; 누구도 거기까지는 ~ 생각하지 못했다 Ещё никто до этого не додумался. (Ещё никто об этом не подумал.)
오인	吾人; я; мы; ; 오인 誤認; неправильное (ошибочное) представление; недоразумение; ~하다 принимать одно за другое; обознаться; неправильно ((ошибочно) представлять себе
담뱃재	сигаретный пепел
요하다	要－; требовать; нуждаться; 휴식을 ~ нуждаться в отдыхе
길들이다	1. наводить блеск (лоск); 2. приручать; укрощать; 3. привить привычку
들개	бродячая (бездомная) собака
필적	匹敵; ~하다 быть ровней (парой); 그에게는 ~할 만한 사람이 없다 Ему нет равных.; 그 여자는 당신에게 ~할 만한 사람이 아니다 Она вам не ровня.; ; 필적 筆跡; почерк; 그는 ~이 좋다 Он пишет хорошим почерком.; 알아보기 어려운 ~ неразборчивый почерк
칭찬	稱讚; похвала; восхваление; похвальный; ~하다 хвалить; восхвалять; 학생의 솔직함을 ~하다 хвалить ученика за честность; ~을 퍼붓다 осыпать похвалами
돌려주다	1. возвращать; 꾼 돈을 ~ возвращать долг; 2. одалживать; давать в займы
다짐	обязательство; обещание; клятва; ~하다 давать обязательство; обещать; ~을 받다 взять обязательство
용의자	容疑者; подозреваемое лицо; подозреваемый; заподозренный; 살인사건의 ~ подозреваемый в убийстве
꽁무니	хвостец; копчик; зад; задница; самый конец; хвост чего-либо; ~ 를 빼다 потихоньку сбежать; ~를 사리다 в страхе броситься бежать; опасаться; остерегаться
반경	半徑; радиус; ~를 긋다 провести (начертить) радиус
젖다	намокать; становиться влажным (сырым)
통	1. кочан; кочанный; 배추 몇 ~ несколько кочанов капусты; 2. окружность; ширина; 다리 ~이 굵다 толстые ноги; ~이 크다 великодушный; благородный; 3. группа; толпа; сборище; 한 ~이 되다 объединяться; группироваться; 4. ~에по причине; в результате чего; 너무 떠드는 ~에 잘 들리지 않는다 Из-за шума плохо слышно.; 5. совсем; целиком; совершенно; 나는 그의 소식을 ~ 모른다 Мне о нём совсем ничего не известно.; ~ 말이 없다 не промолвить ни слова; ~ 알 길이 없다 узнать совершенно невозможно; 6. цельный; целый; ~마늘 целая головка чеснока; ~나무 целое бревно; ; 통 桶; бочка; кадка; ведро; чан; бачок; ванна; ~을 짜다 собирать (монтировать) бочку; ; 통 筒; труба; ; 통 統; пять дворов; ; 통 通; знаток; осведомлённый человек; проспект; улица; 해안~ приморская набережная
양화점	洋靴店; обувной магазин
총탄	銃彈; пуля
찻집	茶-; чайная; кафе; закусочная
차라리	лучше; скорее; охотнее; предпочтительно; 이것은 ~ 그에게 물어보는 편이 나았을 것이다 Лучше бы тебе спросить его об этом.; 수치를 당하느니 차리리 죽는것이 낫다 Лучше умереть, чем вести позорную жизнь.
힐끗	~ 보다 искоса взглянуть
연못	蓮-; лотосовый пруд
고성	古城; древняя крепость; ; 고성 高聲; громкий голос; ~으로 громко; во весь голос; ~방가 하다 петь во весь голос (громко)
성벽	城壁; крепостная стена; оплот; ; 성벽 性癖; укоренившаяся дурная привычка
둘러싸이다	be besieged[invested / surround / enclosed / girded]
성내	城內; внутри крепости; в городе
밀집	密集; концентрация; скученность; ~하다 концентрироваться; скучиваться; тесниться; толпиться
왕래	往來; уличное движение; общение; связь; переписка; ~하다 ходить (ездить) туда и обратно; курсировать; поддерживать связь; общаться; переписываться; 서신~ переписка
골목	переулок; ~ ~ в каждом переулке; ~대장 главарь; коновод; заводила
즐비	櫛比; ~하다 расположенные в ряд
신음	呻吟; стон; ~하다 стонать; изнывать; томиться чем; 농민들은 농노제도의 속박 아래서 ~해 왔다 Крестьянство стонало крепостного права.
패	牌; группа; партия; компания; дощечка с надписью; жетон; ярлык; торговая марка; карта; ~를 짓다 образовать группу; ~를 잡다 держать банк; быть банкомётом
밀어내다	выталкивать; вытеснять; вытаскивать; выдвигать
복판	середина; центр
잔인	殘忍; ~하다 жестокий; безжалостный; зверский
노파	老婆; старуха; старушка; ~의 старушечий
몹쓸	плохой; порочный; дурной; негодный
단단히	hard; solidly; firmly.
혼	魂; дух; душа; привидение; призрак; ＝넋
달려들다	at; pounce upon; fly[spring] at;
때리다	1. (치다) бить; избивать; ударять; 얼굴을 ~ бить (ударить) в лицо; 뺨을 ~ дать пощечину; 지팡이로 ~ бить (ударить) палкой; 2. (비난하다) резко критиковать; порицать; осуждать; обвинять; 신문에서 ~ обвинять (кого-либо) в прессе; 그는 어제 나를 때리는 말을 여러 사람에게 하였다 Он публично обвинил меня вчера.
까닭	причина; повод; ~ 없이 ни с того ни с сего; 이러한 ~에 по этой причине; по этому поводу
젊은이	молодой человек
쓰다듬다	1. гладить; поглаживать; 2. утешать; уговаривать
호소	呼訴; призыв; обращение; воззвание; жалоба; ~하다 призывать к кому-чему; обращаться к кому-чему; взывать к кому-чему о чём; подавать жалобу; жаловаться; ; 호소 湖沼; озеро и болото
온몸	все тело; ~몸이 떨리다 дрожать всем телом; ~몸에 по всему телу
피투성이	окровавленный человек (предмет); ~가 되다 быть окровавленным; окровавливаться; ~가 된 시체 окровавленный труп
메마르다	сухой; неплодородный; сухой; нечувствительный
기어가다	앞으로 나아가다
리어카	a rear-car; a bicycle(-drawn) cart
빌리다	давать в долг (взаймы; напрокат); сдавать в аренду; прибегать к помощи; занимать; основываться (на чем-л.); исходить (из чего-л.); выпрашивать; 책을 ~ брать взаймы книгу; 돈을 빌려 주다 давать взаймы деньги; 네 요약 노트를 이틀간 빌려줄 수 있니? Можно мне взять твой конспект на два дня?
상점	商店; магазин; ~을 열다 (닫다) открывать (закрывать) магазин; 담배를 사기 위해 ~에 들렀다 Я зашёл в магазин, чтобы купить сигарет.
운반	運搬; перевозка;, транспортировка; ~하다 перевозить; транспортировать
영차	Yo-ho!; Yo-heave-ho!
깔리다	быть подстеленным (разостланным; расстеленным); 자동차 에~ попасть под машину
덜커덕	a click; thump; plump;
뻗치다	протянуть; 구조의 손을 ~ протягивать руку помощи
경련	痙攣; судорога; конвульсия; подёргивание; спазм; ~이 일다(~하다) сводить что судорогой; подёргиваться; 심장~ сердечные спазмы; 피부~ спазмодермия
일으키다	поднимать; возбуждать; вызывать; 공포심을 ~ вызвать страх; 호기심을 ~ возбудить любопытство; 먼지를 ~ поднимать пыль
손대다	touch; lay[put] one's hands on
낯설다	незнакомый; 낯선 사람 незнакомец
플래시	англ. flash; вспышка; сверкание; вспышка; лампа; ручной электрический фонарь; ~를 터뜨리다 зажигать лампу-вспышку
스웨터	sweater; свитер
전망	展望; обозрение; обзор; перспектива; ~하다 обозревать; 정치~ политическое обозрение
방해	妨害; препятствие; помеха; преграда; ~하다 мешать (кому-чему); препятствовать; тормозить; чинить препятствия; ~가 되다 быть помехой (препятствием); ~되지 않습니까? Не помешаю вам?; 라디오가 공부하는 데 ~가 되었다 Радио мешало мне заниматься
마땅	~하다 подходящий; соответствующий; должный; правильный; 마음에 ~하다 быть по душе; нравится; ~히 должным образом, как подобает
안뜰	a courtyard; a[an inner] court
쌓다	складывать; накладывать; наваливать; касть; накапливать; сложить в кучу; 경험을 ~ накапливать опыт; 장작을 창고에 ~ складывать дрова в сарай; 자루를 차곡차곡 ~ наваливать один мешок на другой
헛간	－間; сарай; склад; амбар
수의사	獸醫師; ветеринарный врач; ветеринар
짚	солома; ~단 пучок соломы; ~바리 стог; сноп сена; ~불 горящая рисовая солома
깔다	подстилать; стелить; давить; 식탁에 식탁보를 ~ стелить скатерть на стол
담요	одеяло; 푹신한 ~ пушистое одеяло; ~를 깔다 разостлать одеяло; ~를 덮다 укрываться одеялом; закутаться в одеяло
눕히다	укладывать кого в что; 벽돌을 눕혀 쌓다 класть кирпич плашмя; 환자를 침대에 ~ уложить больного на кровать
늘어지다	удлиняться; растягиваться; свисать; обвисать; замедляться; сникнуть; размякнуть; спокойный; 늘어지게 잠을 자다 отоспаться; выспаться; 팔자가 ~ жить спокойно; 버드나무 가지가 늘어진다 Ветки ивы свисают.
덩어리	1.ком; глыба; кусок; 금 ~ слиток золота; 기름 ~ кусок жира; 한 ~가 되다 сплотиться воедино (в одно целое); 2.масса
원기	元氣; бодрость; энергия; ~가 왕성하다 энергичный; ~를 내다 приободряться; ~를 북돋우다 ободрять; придавать бодрости
조차	даже; аж; вдобавок; вместе с тем; притом; к тому же; кроме того; в добавление к тому; а тут ещё; 상상~ 못하다 даже невозможно (не могу) представить себе этого; ...를 쳐다보기~ 하지 않다 даже не взглянуть на кого; 따뜻하다 못해 덥기~ 했다 Было очень тепло, даже жарко.; 이는 아이들~ 다 아는 것이다 Это даже детям хорошо известно.; ; 조차 潮差; амплитуда прилива
빼내다	отнимать; вычитать; вытаскивать; 가시를 ~ вытаскивать занозу; 좋은 것을 ~ выбирать лучшее; 짐을 ~ вытаскивать багаж; 나는 반지를 빼냈다 Я снял кольцо.; 그물에서 고기를 ~ выпутывать из сети рыбу
붕대	繃帶; бинт; ~를 감다 перевязывать бинтом
전투	戰鬪; бой; битва; ~하다 вести бой
원고	原告; истец; истцовый; ~와 피고 истец и ответчик; ; 원고 原稿; рукопись; ~를 쓰다 писать
작성	作成; составление; оформление; ~하다 составлять; оформлять
본사	本寺; главный буддийский храм; ; 본사 本社; главный офис; наша компания
와중	渦中; ~에 в вихре; в водовороте; 사건 ~에 в вихре событий
즈음	в то время; когда ...; ..에 ~하여 по случаю; в связи с чем
턱	1. челюсть; подбородок; ~을 악물다 сжимать (стискивать) челюсти; 위~ верхняя челюсть; 아래~ нижняя челюсть; 2. порог; небольшой выступ; ~이 지다 иметь выступ; немного выступать; 3. угощение по случаю какого события; 한 ~내다 угощать по случаю радостного события; 4. основание; мотив; повод; причина; 이런 일을 할 ~ 있나 Нет причины делать это.; 5. вдруг, неожиданно; совсем; сильно; крепко; невозмутимо; ~ 멎다 вдруг остановиться; ~ 쓰러지다 неожиданно упасть; 마음을 ~ 놓다 успокоиться; 숨이 ~ 막혔다 Сильно захватило дух.; ~ 잡다 крепко взять; 문앞에 ~ 버티고 서다 невозмутимо встать в дверях
단정	斷定; окончательное заключение (суждение); ~적인 окончательный, категорический; ~하다 делать окончательное заключение (суждение); ; 단정 端正; ~하다 аккуратный; правильный; 옷차림이 ~하다 аккуратно одеваться
전쟁터	戰爭－; поле боя
왁자지껄	~하다 шуметь; ~한 이야기 소리 шумный говор; 싸우는 ~하는 소리 шум от драки
찡그리다	хмурить брови; насупиться; смотреть неодобрительно; искажать; 그는 아픔을 견디지 못해 얼굴을 찡그렸다 Его лицо исказилось от боли.; 눈썹을 ~ хмурить брови; 얼굴을 ~ морщить лицо
우습다	смешной; забавный; комичный; смешной ; смехотворный
좍	쫙 брызнуть тонкой струёй
퍼지다	раздаваться вширь; расширяться; расплодиться; широко распространяться; широко простираться; набухать; разбухать; увеличиваться; 기쁜 소식이 온 나라에 퍼졌다 Радостная весть широко распространялась по всей стране.; 피가 온 몸에 퍼진다 Кровь разносится по всему телу.; 얼굴에 미소가 퍼졌다 По лицу разлилась улыбка.
단서	但書; исходный пункт; ключ; начало; путеводная нить; ~가 되다 служить поводом; ~를 잡다 найти ключ к чему
쓸데없다	ненужный; бесполезный; лишний; 쓸데없는 책 ненужная книга
동요	動搖; колебания; волнения; колебание; нерешительность; неустойчивость; флуктуация (флюктуация); ~하는 колеблющийся; нерешительный; неустойчивый; ~하다 колебаться; волноваться; не решаться; флуктуировать; ~없이 без колебаний; 민중의 ~ народные волнения; 사상의 ~ брожение идей; ; 동요 童謠; песня для детей; детская песня; ~ 경연대회에 참가하다 участвовать в конкурсе песен для детей; ~를 부르다 петь детскую песню
공격	攻擊; атака; штурм; наступление; нападение; нападки; ~적 наступательный; ~하다 атаковать; штурмовать; наступать; нападать; критиковать; 기습~ внезапное нападение; 정면~ фронтальное наступление; лобовая атака; 측면~ фланговая атака
우물우물	in swarms;
코웃음	ироническая усмешка; ~(을) 치다 скривить лицо в усмешке; усмехаться
한층	－層; ещё более; ~ 노력하다 сделать ещё большее усилие; ~ 강력한 ещё более мощный
어리석다	глупый; тупой; бестолковый; 어리석은 사람 глупец; 어리석음 глупость
틀어박히다	быть изолированным; быть заключённым; 방안에 ~ не выходить из комнаты; 수도원에 ~ быть заключённым в монастырь
덧붙이다	1. добавлять (сверх полагающегося); 덧붙여 주의를 주다 дополнительно уделять внимание; 2. прикреплять; приклеивать
투고	投稿; ~하다 писать и посылать в журнал (газету); 논문을 학술지에 ~하다 писать и посылать статью в научный журнал
우편	郵便; почта; корреспонденция; ~으로 보내다 посылать почтой (по почте); ~주문 заказ по почте; 항공 ~ авиапочта
지급	支給; 1. (지불) уплата; выплата; платеж; оплата; ~하다 платить; 2. (공급) поставка; снабжение; ~하다 постановлять; предусматривать; обеспечивать; ; 지급 至急; срочность; безотлагательность; (перво)очерёдность; неотложность; крайняя необходимость; поспешность; быстрота; ~한 срочный; безотлагательный; ~히 срочно; незамедлительно; неотложно; без проволочки; 매우 ~한 경우에는 в особо срочных случаях; ~을 요하는 수리 срочный ремонт; ~우편으로 전송하다 отправлять срочной почтой; ~에 대한 추가지불 доплата за срочность; 그 일은 ~을요한다 Это срочное дело.
강가	江-; берег реки
갸우뚱	~하다 склониться; наклониться; покоситься; ~거리다 качаться из стороны в сторону; мотать (головой); наклонившийся; покосившийся
통지	通知; сообщение; информация; уведомление; ~하다 сообщать; информировать; уведомлять; осведомлять кого о чём; 사건을 참석자에게 ~하다 осведомлять присутствующих о событии; 해고를 ~하다 уведомлять об увольнении
전과자	前科者; бывший уголовник
겁내다	怯－; бояться; испугаться
기색	氣色; выражение лица; вид; 우울한 ~ угрюмый вид; ~이 좋지 않다 плохо выглядеть; иметь плохой вид; ~을 보이지 않다 не подавать (не показывать) вида
물끄러미	~ 쳐다보다 смотреть не сводя глаз
빗물	дождевая вода
곧장	прямо; напрямик; сразу; немедленно; тут же; ~ 가다 идти напрямик
속기	速記; стенография; стенографический; ~하다 стенографировать; быстро писать; ~록 стенограмма; протокол; ~ 부호 стенографические знаки
해당	該當; ~하다 (형) данный; соответствующий; ~하다 (동) подходить к чему
떠들썩	очень шумный; взволнованный
끼얹다	обливать; обливаться; плескать водой; 머리에 찬물을 ~ обливать голову холодной водой; 서로에게 물을 ~ плескать друг на друга
이어	затем; далее; продолжая; вслед за; сразу же; тут же; ~달리기 эстафета
경직	梗直; ~하다 волевой и искренний (прямой); ; 경직 硬直; твёрдость; непреклонность; жёсткость; негибкость; ~된 отверделый; окостенелый; ~하다 отвердеть; окостенеть
문구	文具; канцелярские принадлежности; ; 문구 文句; фраза; предложение
씻다	мыть; стирать; вытирать; смывать начисто; 손을 ~ мыть руки; 그의 손은 마치 한번도 씻은 적이 없는 것처럼 보인다 У него руки такие, словно он их никогда не моет.; 이 치욕을 씻어버릴 수는 없다 Этого позора не смоешь.; 씻을 수 없는 수치 несмываемый позор
의기	義氣; дух; настроение
양양	揚揚; ~하다 довольный кем-чем; гордый; горделивый; ликующий; победоносный; самодовольный; 의기~하다 победоноспый; ликующий; 의기~하게 торжественно; в приподнятом настроении; самодовольно; ; 양양 洋洋; ~하다 обширный; безбрежный; прекрасный; 그의 전도가 ~하다 У него прекрасные перспективы.
통화	通話; (телефонный) разговор; ~하다 разговаривать (по телефону); ~중이다 телефон занят; ~ 신청 заказ на телефонный разговор; ; 통화 通貨; деньги; валюта; ~ 수촉 (팽창) дефляция (инфляция); ~ 정책 денежная политика; ~ 조절 регулирование денег (денежного обращения); ~ 안정 денежная стабильность; ~ 유통 денежное обращение; ~ 제도 денежная система
속히	速-; быстро; скоро
비명	非命; вопль; крик; ~지르다 вопить; кричать
컵	англ. cup; чашка; кубок; 커피 한 ~ 할래요? Хотите чашку кофе?; 오늘 오후에 은제~ 쟁탈 레이스가 있다 Сегодня после обеда состоятся гонки на серебряный кубок.; 종이~ бумажный стаканчик
긴장	緊張; напряжение; накал; ~된 напряжённый; накалённый; натянутый; ~하다 напрягаться; 몹시 ~하여 с большим напряжением; ~된 정국 напряжённое политическое положение
감시	監視; наблюдение; надзор; инспекция; ~하다 наблюдать; надзирать; инспектировать; ~를 두다 ставить под наблюдение; ~기구 контролирующая организация
석조	石造; сделанное из камня
단언	斷言; утверждение; заявление; ~하다 категорически утверждать; решительно заявлять
의하다	依－; основываться; опираться
독사	毒蛇; ядовитая змея
특징	特徵; особенность; характерный признак; специфика; своеобразный; характерный; ~(을) 짓다 характеризовать(ся); 이것은 우리 공장의 ~적인 제품들이다 Эти изделия, характерные для нашего завода.
장본인	張本人; зачинщик; главарь
세주다	貰－; сдавать в аренду; давать напрокат
식욕	食慾; аппетит; ~이 없는 лишённый аппетита; ~을 돋구다 возбуждать (вызывать) аппетит; ~을 잃다 терять аппетит; ~이 생기다 (없어지다) появиться (пропасть) об аппетите
정전	停戰; прекращение военных действий; перемирие; ~하다 прекращать (военные действия); ; 정전 停電; прекращение подачи тока; ~되다 прекращаться (о токе)
가만히	молча; потихоньку; тайно; украдкой; втихомолку; неподвижно; спокойно; до сих пор; по-прежнему; ~ 떠나다 тайно уезжать
체질	體質; физические; конституция организма
온	весь; целый; ~힘을 다하여 изо всех сил; ~세상 весь мир
마비	痲痺; паралич; оцепенение; ~시키다 парализовать; ~되다отниматься; парализоваться; цепенеть; столбенеть; ~ 환자 паралитик; паралитический; быть парализованным; онемевший; нечувствительный; 소아 ~ детский паралич; 심장 ~ внезапная остановка сердца
중얼거리다	ворчать; говорить тихо; бормотать; шептать кому (на ухо); жаловаться
씻기다	씻다  быть вымытым
식기	食器; столовая посуда
뒷짐	закладывание рук за спину; ~(을) 지다 закладывать руки за спину
야간	夜間; вечер; ночь; ночное время; ~의 ночной; ~에 ночью; ~경기 вечернее (ночное) соревнование; ~관측장비 приборы ночного видения; ~교대 ночная смена; ~근무 ночная служба; ~대학 вечерний институт; ~전투 ночной бой
심부름	мелкие поручения; ~하다 выполнять мелкие поручения; быть на побегушках
불러오다	вызывать
재빨리	быстро; расторопно; проворно; ловко
도망	逃亡; бегство; побег; ~가다 убегать; обращаться в бегство
살며시	украдкой; осторожно; тайком; ~ 집을 나가다 тайком выходить из дома
매달다	вешать; подвешивать; приковывать; привязывать
부슬비	моросящий (мелкий) дождь
어부	漁夫•漁父; рыбак; рыболов
바구니	(плетённая круглая) корзина; 꽃~ корзина цветов
그물	сеть; сетка; невод; ~의 сетевой; сетный; неводный; ~의 잡다 неводить; ~에 걸리다 попадать в сети; ~을 끌다 тянуть невод; ~을 던지다 закидывать невод; ~을 치다 ставить невод; ~질하다 ловить рыбу; ~바늘 игла для вязания сети; ~채 шест рыболовной сети
일제히	一齊-; дружно; все вместе; разом
일손	руки, занятые работой; рабочие руки; ~(을) 놓다(떼다) прекратить работу; ~을 돕다 помогать в работе; ~이 딸리다 нехватает рук
수갑	手匣; перчатки; наручники; ~을 끼다 надевать перчатки; ~을 채우다 надевать наручники
몸집	комплекция; телосложение; 이 아이는 나이에 비해 ~이 크다 Этот ребёнок крупный для своего возраста.
죄수	罪囚; заключённый; узник; преступник; ~를 투옥시키다 посадить (заключить) в тюрьму
좌우	左右; левая и правая стороны; ~에 рядом; сбоку; под боком; ~상칭 двусторонняя симметрия; ~하다 зависеть от кого-чего (в зависимости от чего); влиять ни кого-что; оказывать влияние (действие); действовать на кого-что; своевольничать; решать судьбу (участь) кого; делать погоду; действующий; самовластный; самоуправный; ...의 생각을 ~하다 овладеть мыслями кого
끌려가다	быть тянутым силой
뒤흔들다	сильно качать (трясти); расшатывать
사슬	цепь; 개를 ~로 매다 привязывать собаку на цепь; ~을 풀다 развязывать цепь; 쇠~ 지어 цепью; 쇠~에 맨 개 собака на цепи; 쇠~을 끊다 разорвать цепь
난폭	亂暴; насилие; грубость; ~하다 буйный; грубый; ~한 행실 буйное поведение; ~하게 굴다 буйствовать; грубить
조각	кусок; ломоть; клочок; обрывок; шмат; обрезок; осколок; обломок; краюха; отрез; отрывок; лоскуток; 산산 ~으로 вдребезги; на мелкие куски; кусковой; 빵~ кусок (ломоть) хлеба; 유리~ осколок стекла; 종이 ~ клочок; бумаги; ; 조각 彫刻•雕刻; скульптура; ваяние; гравировка; резьба; ~의 скульптурный; лепной; ~하다 ваять; высекать; вырезать; гравировать; отливать; лепить (из глины); ~으로 꾸미다 украшать скульптурами; 대리석상을 ~하다 высекать из мрамора; ; 조각 組閣; формирование правительства (кабинета); ~하다 формировать (образовывать) кабинет (правительство)
인파	人波; поток людей; толпа
돌진	突進; стремительное продвижение вперёд; натиск; ~하다 стремительно продвигаться; внезапно устремиться; ринуться; 적의 진지를 향해 ~하다 ринуться на позицию противника
사방	四方; четыре стороны света; вокруг; всюду; везде; 남자가 신경질적으로 ~을 종종 쳐다봤다 Мужчина нервно смотрел по сторонам.
여인	女人; женщина
쓸다	1. подметать; мести; сметать; 먼지를 ~ мести сор; 그녀는 방을 쓸었다 Она подмела комнату.; 쓰레기를 현관 아래에 쓸어 넣다 сметать мусор под крыльцо; 2.править; точить
번개	молния; ~의молниевый; ~ 형의молниевидный; ~가 번쩍였다Молния сверкнула.; ~ 가튼 속도로 с быстротой молнии
전번	前番; прошлый (предыдущий, предшествующий) раз
겨누다	целиться; метить; сличать; сравнивать; сопоставлять; примерять; 총을 ~ целиться из винтовки (пистолета)
별도리	別道理 an alternative; a better wa
쥐다	брать что (в руку); держать что (в руке); захватывать что; 손을 꽉 ~ держать кого за руку крепко; 권력을 ~ захватывать власть
미로	迷路; запутанный путь; лабиринт; растерянность; ~에 빠지다 попасть в затруднительное положение
창고	倉庫; склад; амбар; кладовая; пакгауз; сокровищница; клад; ~에 보관하다 помещать в склад; хранить на складе; ~지기 работник (служащий), на складе; кладовщик; 세관~ таможенный пакгауз
맨발	голые (необутые) ноги; ~로 босиком; ~(을) 벗다 быть босым (разутым)
헌병	憲兵; жандарм; жандармерия
일대	一代; (одно) поколение; (вся) жизнь; 일생~에 한번 밖에 없는 일 единственный случай в жизни; ; 일대 一帶; весь район; вся местность; зона; 에 кругом; повсюду
한가	閑暇; ~하다 свободный; незанятый; праздный; ~로이 на досуге; праздно; 집에서 ~로이 시간을 보내다 праздно проводить время дома
다짜고짜	как попало; как вздумается; без разбора (спроса); 그는 ~ 나를 의심부터 한다 Он, не разобравшись, стал подозревать меня.
점잖다	солидный; важный; благородный; утончённый
동풍	東風; восточный ветер
장관	壯觀; грандиозный вид; величественное зрелище; ; 장관 長官; министр; начальник; 국무~ государственный секретарь
방자	放恣; избалованность; наглость; ~하다 своевольный; самовольный; своенравный; наглый
흉악범	凶惡犯
벙어리	немой; ~와 봉사가 싸우면 누가 이길까요? Если будут драться немой и слепой, то кто победит?
예사	例事; обычное дело; обычная практика; ~가 아닌 необычный; ~롭다 обычный; обыденный; ~로이 обычно
유령	幽靈; привидение; призрак; ~인구 население, значащееся только по документам; ~ 주식회사 фиктивное акционерное общество
보잘것없다	ничтожный; непривлекательный; нестоящий
순경	巡警; патруль; (рядовой) полицейский
고참	古參; старший (по возрасту; по положению); старожил; ветеран; ~의 старший; опытный
장난	шалость; баловство; проказы; ~하다 шалить; проказничать; баловаться
지나치다	превышать; превосходить; быть чрезмерным (излишним)
굵다	толстый; крупный; большой; басистый; громкий; мощный; грубый
술술	~ 풀다 легко разматываться; 비밀을 ~ 털어놓다 рассказать всё без утайки
원대	遠大; ~하다 грандиозный; далеко идущий; ~한 구상 далеко идущий замысел
벙벙	~하다 ошеломлённый; растерянный; 영문을 몰라 벙벙하게 서있다 стоять в растерянности; 들판에 물이 ~하다 В долине разлилась вода.
멍청	~하다 растерянный; ошеломлённый; глупый; 멍청히растерянно; глупо
진담	珍談; чудесный рассказ; ; 진담 眞談; правдивые слова; ; 진담 陳談; банальный разговор
시설	施設; учреждение; оборудование; сооружение; ~하다 оборудовать; оснащать; сооружать; 관개 ~ ирригационные сооружения; 국가 ~ государственное учреждение
감방	監房; тюремная камера; тюрьма; ~에 처넣다 посадить (бросить) в тюрьму
헌병대	憲兵隊; жандармский отряд; отряд жандармов
연행	連行; препровождение; ~하다 препровождать
이르다	1. достигать; доходить; добираться; 결론에 ~ прийти к выводу; 높은 수준에 ~ достигнуть высокого уровня; 목적지에 ~ добраться до места назначения; 2. говорить; называть
갑작스럽다	внезапный; неожиданный; 갑작스러운 변화 внезапная перемена
깜박거리다	flicker; waver; shimmer
도무지	совсем; совершенно; вовсе
영문	причина; обстоятельство; ~을 모르다 не знать, в чём дело
엉망	путаница; беспорядок; кутерьма; ~이 되다 портиться
재수	財數; везение; ~없다 не повезло
단념	斷念; отказ; отречение; ~하다 отказаться ( от чего-л. задуманного); 해외여행 갈 생각을 ~하다 отказаться от мысли поехать за границу
나이프	англ. knife; нож; ~ 스위치 электр. рубильник
아랑곳없이	unconcernedly; with an air of perfect nonchalance
망대	望臺; наблюдательная вышка (башня)
놓치다	упускать; выпускать; пропускать; 좋은 기회를 ~ упустить счастливый случай; 그녀는 단한마디도 놓치지 않고 강의를 주의 깊게 들었다 Она слушала лекцию внимательно, не пропуская ни одного слова.
붙잡히다	быть схваченным (задержанным)
가지각색	--各色; разнообразный; всех мастей; 가지각색의 사람들 самые разные люди
인부	人夫; чернорабочий; землекоп; грузчик; стивидор
그다지	так; настолько; не так уж; не очень; не особенно; 나는 이 책에 ~ 흥미가 없다 Я не особенно интересуюсь этой книгой.
눈치	догадливость; смекалка; ~가 빠르다 догадливый; смекалистый; ~가 없다 недогадливый; несмышлёный; ~를 보다 делать с оглядкой; засматривать (кому) в глаза; влезать в (чью) душу; ~를 채다 догадываться; замечать (что); ~보기 оглядка
평판	平板; гладкая (ровная) доска; ~ 측량기 мензула; ; 평판 評判; репутация; популярность; суждение; отзывы; разговоры; слухи; ~이 좋은 имеющий хорошую репутацию; известный; ~이 나쁜 пользующийся дурной славой; ~을 나쁘게 하다 испортить репутацию
상류	上流; верхнее течение; верховье; ~사회에서 태어나다 рождаться в высшем обществе
계급	階級; класс; каста; звание; классовый; ~구성 классовый состав; ~분화 классовое расслоение; ~사회 классовое общество; ~적 모순 классовые противоречия
내세우다	выставлять; выдвигать; ставить; превозносить; ставить (что) выше (чего); высоко оценивать; 개인의 이익보다 집단의 이익을 더 ~ ставить интересы коллектива выше личных; 대표자로 ~ выдвигать (кого) представителем; 이 싸구려 소설에는 새롭게 내세울 만한 아무것도 없다 В этом дешёвом романе нет ничего нового, на что можно было бы обратить внимание.
뻐기다	хвастаться; 몹시 ~ не в меру хвастаться
클럽	англ. club; 1. клуб; ~ 회원 член клуба; 2. клюшка для гольфа
감격	感激; волнение; глубокое впечатление; умиление; ~적인 трогательный; производящий глубокое впечатление; драматичный; ~하다 быть взволнованным (тронутым); ~시키다 растрогать
어느덧	незаметно; невольно; неожиданно
벗어나다	1. освободиться (от чего-либо); выходить; выбираться; избегать; 위기에서 ~ избегать опасность; 가난에서 ~ выбраться из бедноты; 벗어날 길을 찾다 найти выход; 2. идти вразрез; противоречить (кому; чему); быть обратным; 기대에 ~ противоречить ожиданиям; 관습에 ~ идти вразрез с традициями; 규칙에 ~ против правил; 3. сойти (с чего-то); 기차가 레일에서 벗어났다 поезд сошёл с рельсов
굳다	1. крепкий; твёрдый; прочный; 2. напряжённый; ; 3. скупой; прижимистый; 4. затвердевать; 5. копиться; 굳은 살 сухая мозоль
외로이	одиноко
인가	人家; дом; жилище; ; 인가 認可; разрешение; санкция; признание; одобрение; ~하다 разрешать; санкционировать; признавать; одобрять
튀어나오다	rush[burst] out;
추측	推測; предположение; ~하다 предполагать; догадываться
경비원	警備員; охранник
선박	船舶; судно; судовой; ~ 건조 судостроение; ~ 급수 класс судов
무너뜨리다	рушить; обваливать; ломать
비탈길	дорога по крутому склону
닿다	соприкасаться с чем; прикасаться; доставать чего (до чего); добираться до чего; доноситься до чего; достигать чего (до чего); устанавливаться; 목적지에 ~ добираться до назначенного места; 손이 책상에 ~ прикоснуться рукой к столу; 기차가 정시에 닿았다 Поезд прибыл точно в установленное время.; 그는 힘이 닿는 데까지 달렸다 Он бежал что есть силы.; 전쟁 소식이 우리 마을에까지 닿았다 Весть о войне дошла до нашего села.
부서지다	разбиваться; крошиться; разбрызгиваться; ломаться; рушиться; 산산이 ~ разбиваться вдребезги; 책상이 ~ стол ломается; 우승의 꿈이 산산이 부서졌다 Мечта о победе разбилась вдребезги.
둘레	окружность; 가슴 ~ объём груди; ~에 вокруг
새기다	вырезать по дереву (металлу); делать скульптуру
안내인	案內人; гид; сопровождающий; проводник
지피다	зажигать; разжигать; поджигать; растапливать; 벽난로에 불을 ~ разжигать огонь в камине; 석탄을 ~ разжигать уголь; 장작을 ~ подкладывать дрова
폭풍우	暴風雨; буря и ливень
휘몰아치다	blow violently[boisterously]; blow hard (and strong); bluster; rage; rave; roar;
동전	銅錢; медная монета; ~ 한 닢 없다 ни гроша нет
엽서	葉書; почтовая карточка
거치다	заходить за что; заезжать за что; преодолевать; задевать; спотыкаться; 거쳐서 через что
탑	塔; башня; пагода; обелиск; шпиц; шпиль; 오층~ пятиэтажная пагода
골다	코를 ~ храпеть
굉장	宏壯; ~하다 внушительный, величественный, грандиозный; 굉장히 крайне, чрезвычайно; 굉장히 나쁘다 ужасный
얼른	быстро; живо
반항	反抗; сопротивление; противоборство; противодействие; протест; отпор; ~하다 сопротивляться; противодействовать; противиться; протестовать; давать отпор; ~적인 сопротивляющийся; противодействующий
신분	身分; общественное (социальное) положение; профессии; личность; индивидуум; лицо; сословие; ~적 сословный; ~을 밝히다 установить личность кого; ~을 속이다 скрывать свою сущность; скрывать своё лицо; 농노 ~ крепостное сословие
증명서	證明書; документ; свидетельство; сертификат; аттестат (официальный документ о получении какого-л. образования); письменное доказательство (свидетельство); ордер; варрант
소동	騷動; беспорядки; волнения; шум; шумиха; ~하다 учинять (беспорядки, скандал); поднимать (шум, шумиху)
벌이다	раскладывать; расставлять; распростирать; начинать; основывать; открывать
닻	якорь; ~을 감아 올리다 выбирать якорь; ~을 내리다 бросать якорь; становиться на якорь; ~을 올리다 поднимать якорь; сниматься с якоря
글자	－字; буква; письменный знак; литера; ~의 буквенный; ~ 그대로 буквально; точно; в буквальном смысле; ~판 циферблат
모닥불	костёр
잿더미	груда пепла (золы); ~로 만들다 обратить (превратить) в пепел
부스러기	куски; осколки; 과자~를 치워라 Убери остатки печенья.
조개	двустворчатые (раковинные) моллюски; беспозвоночное; мягкотелое животное, обычно покрытое раковиной; моллюсковый; ~살 мясо двустворчатых моллюсков
껍질	скорлупа; кожура; корка; кора; оболочка; ~을 벗기다 очищать кожуру; 귤~ мандаринная корка; 빵~ хлебная корка
도둑맞다	быть обкраденным (ограбленным)
도둑	вор; ~의 воровской; ~맞다 быть обкраденным (ограбленным)
분량	分量; доза; количество; вес; объём; 약의 ~ доза лекарства; ~이 너무 많다 Доза очень велика.
흉기	凶器; смертоносное оружие
잔돈	мелочь; мелкие деньги; сдача
푼	немного денег; гроши; 나는 한~도 남기지 않고 모두 써버렸다 Я истратил всё до гроша.; 나는 한~도 없다 У меня нет ни гроша.
자루	1. мешок; ~에 넣다 класть в мешок; 2. рукоятка; ручка; 도끼~ рукоятка топора
베다	подкладывать под голову; резать; рубить; 나무를 베어냈다 Дерево перерубили.
모자라다	недоставать; не хватать; быть неразвитым
영리	怜悧•伶; ~하다 умный; сообразительный; ; 영리 營利; извлечение прибыли (выгоды); ~를 도외시하면서 безвозмездно; не помышляя (без мысли) о выгоде
방심	放心; отсутствие мыслей; умиротворённость; ~하다 проявлять благодушие; быть рассеянным; витать в облаках
비틀다	крутить; скручивать; закручивать; мешать (делу; работе); 팔을 ~ скрутить руки
미망인	未亡人; вдова
세력가	勢力家; влиятельный человек
드리우다	опускать; свешивать; висеть; свешиваться; 지붕에서 밧줄을 ~ свешивать верёвку с крыши
나부끼다	развеваться, реять; 깃발이 바람에 Знамя развевается на ветру.
교섭	交涉; переговоры; сделка; ~하다 вести переговоры; заключать сделку; 단체~ коллективные переговоры
되도록	по возможности; как можно; ~ 좋게 как можно лучше
정중	鄭重; ~하다 солидный; внушительный; приветливый; вежливый; обходительный; ~한 인사 почтительный поклон
다루다	обращаться с кем-чем; управлять чем; владеть кем-чем; 공작기계를 ~ управлять станком; 아이들을 ~ обращаться с детьми
분부	分付; 吩咐; ~하다 приказывать; велеть; ~에 따르다 следовать приказу
열쇠	ключ; ~로 문을 열다 отпирать дверь ключом; ~로 문을 잠그다 запирать дверь на ключ; 문제 해결의~ ключ к разрешению проблемы
형무소	刑務所; = 교도소
갇히다	быть (находиться) в заточении (взаперти); 감옥에 ~ находиться в тюрьме; 비 때문에 온종일 집안에 갇혀 있었다 Из-за дождя весь день просидел взаперти.
방지	防止; предотвращение; предохранение; защита; ~하다 предотвращать; предохранять (от кого-чего) предупреждать; 재난을 미연의 ~하다 предотвращать несчастье; 국제적 대기 오염 ~ международно правовая защита атмосферного воздуха от загрязнения; 해양 환경의 오염 ~ защита морской среды от загрязнения
띠	пояс; ремень; узкая полоска материи; лента; ~를 매다 подпоясаться; надеть пояс; ~를 풀다 расстегнуть пояс; снять пояс
멜빵	подтяжки; помочи
압수	押收; конфискация; реквизиция; ~하다 конфисковать; реквизировать
가두다	запирать; запереть на замок; запираться на замок; держать взаперти; 감방에 ~ заключать в тюрьму
걸터앉다	сидеть на краю (стула; дивана)
미신	迷信; суеверие; предрассудок; слепая вера; культ
얼마간	－間; более или менее; некоторое время
예언	豫言; предсказание; пророчество; ~적 пророческий; ~하다 предсказывать; пророчить что; пророчествовать о чем
여배우	女俳優; актриса
초청	招請; приглашение; ~으로 по приглашению; ~하다 приглашать
하도	очень; слишком; чересчур; 엊저녁에 나는 ~ 많이 마셔서 일어날 수 없다 Вчера вечером я выпил слишком много и не могу встать с постели.
비참	悲慘; печаль; горесть; ~하다 печальный; горестный; ~히 горестно; печально; ~한 광경 печальное зрелище; ~한 인생 печальная жизнь
소름	мурашки; ~끼치다 мурашки бегают по спине; мороз по коже пробирает; ~이 돋다 покрыться мурашками
끼치다	1. покрываться гусиной кожей; бить; 고약한 냄새가 확 ~ неприятный запах бил резко в нос; 2. наносить; причинять (ущерб; вред); затруднять; оказывать влияние (благодеяние); влиять; 폐를 ~ причинять беспокойство; 폐를 끼쳐서 죄송합니다 Извините за беспокойство.; 좋은 영향을 ~ оказывать благотворное влияние
빙빙	~ 돌다 кружиться; вертеться; вращаться
미숙아	младенец до 1 мес
신장	伸張; экспансия; расширение; увеличение; рост; ~된 экспансионистский; расширенный; ~에 도움이 되는 способствующий росту; ~시키다 расширяться; увеличиваться; 경제적 ~ экономическая экспансия; ; 신장 新裝; новый наряд; новая экипировка; ~하다 нарядйться; экипироваться; новый товар; новое изделие; ; 신장 腎臟; (анатом.) почка; ~결석 нефролит; ; 신장 身長; рост; ростовой; ~이 큰 사람 человек высокого роста; 그의 ~은 얼마나 되는가? Какого он роста?
경멸	輕蔑; пренебрежение; презрение; ~하다 презирать; пренебрегать
바르다	1. мазать; намазывать; штукатурить; обмазывать; 빵에 버터를 ~ (на)мазать на хлеб масло; 2. прямой; неизогнутый; правильный; правдивый; честный; справедливый; 3. = 발라내다
쇠창살	iron window bar; a grate;
끼이다	1. класть между; застрять между; быть зажатым между; 음식이 잇새에 끼이다 Остаток пищи застрял между зуюов.; 손가락이 문에 끼였다 Мои пальцы прижало дверью.; 2. быть между; находиться между; 나는 두 사람 사이에 끼여서 난처하였다 Я запутался между двумя людьми.; 그 나라는 양대국 사이에 끼여 있다 Эта страна зажата двумя сверхдержавами.; 3. быть тесным (близким); 구두가 너무 꼭 끼인다 Мне жмут ботинки.; 이 웃옷은 내게 너무 끼인다 Эта куртка слишком тесная для меня.; 4. занять место; 이 사업에 한 몫 끼이지 않겠니 Не хочешь ли быть в этом бизнесе?
습격	襲擊; налёт; штурм; нападение; ~하다 нападать; атаковать; штурмовать; совершить налёт; ~ 당하다 подвергаться налёту (нападению)
감싸다	1. обертывать; завертывать; 2. покрывать; брать под защиту; 죄인을 ~ покрывать преступника
두드리다	стучать; бить; колотить; 문을 ~ стучать в дверь; 주먹으로 ~ бить кулаком
털다	стряхивать; вытряхивать; выбивать; сметать; обворовать; обчистить; 옷의 먼지를 ~ стряхивать с одежды пыль; 지붕에서 눈을 털어내다 сметать снег с крыши; 도둑이 빈 집을 ~ вор обворовывает пустой дом
둔갑	遁甲; маскировка; перевоплощение; ~하다 маскироваться; перевоплощаться
부딪치다	сильно удариться; с силой столкнуться; встретить; столкнуться; 문에 머리를 ~ удариться головой дверь; 난관에 ~ сталкиваться с трудностями; 일에 ~ сталкиваться с работой
빼앗다	отнимать; 건달들이 내 돈을 빼앗았다 Хулиганы отняли у меня деньги.; 목숨을 ~ отнимать жизнь; 미안해, 내가 많은 시간을 빼앗아서 Извини, что я отнял у тебя много времени.
존경	尊敬; уважение; почтение; благоговение к кому (перед кем); ~의 почтенный; уважаемый; ~하다 уважать; почитать; ~을 표하다 почитать; относиться с уважением; ~을 받다 завоевать уважение; пользоваться уважением; 스승으로 ~하다 уважать кого как учителя
개폐교	開閉橋; разводной мост
실은	實－; на (в) самом деле
상인	商人; торговец; купец; коммерсант
말대꾸	возражение; выражение своего мнения; ~하다 возражать; высказывать (выражать) своё мнение
태연	泰然; ~하다 спокойный; хладнокровный; невозмутимый
경과	經過; ход; процесс; течение; развитие; ~하다 проводить; проходить; миновать; истекать; ~가 좋다 развиваться (идти; течь) благоприятно; 기한의 ~ истечение срока; ~ 보고 отчёт; отчётный доклад
회복	回復•恢復; восстановление; возвращение; возрождение; выздоровление; поправление; реабилитация; ~하다 восстановить; возродиться; выздороветь; реабилитироваться
저격	狙擊; прицельная стрельба; ~하다 стрелять
돛	парус; ~을 달다 поднять паруса
썰물	отлив; отливная вода
덮이다	покрыться; быть покрытым (накрытым)
경치	景致; вид; пейзаж
홀리다	быть очарованным (соблазнённым); быть обманутым; очаровываться; соблазняться
추리	推理; вывод; заключение; умозаключение; ~하다 приходить к умозаключёнию; ~ 소설 детективная повесть
부랑자	浮浪者; бродяга
피습	被襲; = 피격 be attacked; be assaulted;
조작	操作; управление; вождение; обращение с чем; ~하다 управлять кем-чем; водить; править чем; обращаться с чем; ; 조작 造作; подделка; фальсификация; измышление; ~하다 подделывать; измышлять; 문서를 ~하다 изготовлять фальшивые документы; 서명을 ~하다 подделывать чью подпись; ~된 보도 ложное сообщение; ~된 소문 ложные слухи
실업가	實業家; делец; предприниматель
공장	工匠; ремесленник; ; 공장 工場; завод; фабрика; ~의 заводской; фабричный; ~ 위원회 фабрично-заводской комитет; ~ 지대 фабрично-заводской (промышленный) район; ~폐쇠 локаут; закрытие фабрики (завода)
미워하다	ненавидеть; недолюбливать; невзлюбить
놈팡이	мужлан
에워싸다	окружать; обступать; ...에 에워싸여 в окружении кого-чего
퍼붓다	сильно идти; валить; засыпать чем; 질문을 ~ засыпать вопросами; 찬문을 ~ обдать холодной водой; 욕설을 ~ обрушиваться с бранью; осыпать ругательствами; 함박눈이 ~ снег валит хлопьями
자백	自白; признание; сознание; ~하다 признаваться; сознаваться
진상	眞相; действительное положение вещей; действительная картина
실망	失望; утрата надежды; разочарование; отчаяние; ~한 разочарованный; ~하다 терять надежду; разочаровываться в ком-чём; 그는 나를 ~시켰다 Он разочаровал меня.; 나는 완전히 그에게 ~했다 Я совсем разочаровался в нём.; 어떤 일이 있더라도 ~하지 마시오 Что бы ни случилось, не теряйте надежды.; 이 소식은 그를 ~시켰다 Эта весть разочаровала его.
단숨에	單－; единым духом; в один прием; без перерыва; ~에 마시다 выпить залпом
성급	性急; 하다 нетерпеливый; горячий; ~하게 нетерпеливо; с нетерпением; торопливо
내젓다	размахивать чем перед собой; выгребать (вёслами); 노를 ~ грести вёслами; 팔을 ~ размахивать руками
따름	только; лишь; просто; 당연한 일을 했을 ~이다 Я просто сделал то, что надо сделать.
각자	各自; каждый человек; каждый; всякий; личный; свой; 우리는 ~ 자기의 일로 바쁘다 каждый занят своим собственным делом
나름	~이다 зависит от, определяется тем; 각자 ~대로 кому как; 이것은 하기 ~이다 Это зависит от того, как работать.
활기	活氣; одушевление; оживление; живость; энергия; ~있는 оживлённый; живой; энергичный; ~가 없는 неживой; безжизненный; вялый; ~가 붙다 оживляться
예의	禮儀; этикет; правила приличия; ~ 바르다 вежливый; воспитанный; хорошие манеры; ~상 из вежливости; ради этикета; ~지국 страна высокой нравственности; ; 예의 銳意; усердно; ревностно; прилежно; неутомимо; ~ 검토하다 рассматривать усердно (прилежно)
파수	把守; страж; караул; ~를 보다 стоять на страже; караулить; сторожить
기웃거리다	1. покачивать; вертеть; 고개를 ~ вертеть головой; 2. заглядывать; подглядывать; подсматривать
기호	嗜好; вкус; склонность; ~에 맞다 соответствовать(отвечать)чьим вкусам; ~에 맞지 않다 приходиться не по вкусу; ; 기호 記號; знак; символ; ~의 знаковый; ~체계 знаковые системы
천장	天障; потолок; ~에 매달려 있다 висеть на потолке
널빤지	доска, обшивная доска или планка
사닥다리	лестница; ~로 올라가다 взбираться по лестнице; ~로 내려가다 спускаться по лестнице
문틈	門-; щель (щёлка) в двери
양철	洋鐵; жесть; жестяной; ~깡통 жестянка; жестяная коробка; ~지붕 жестяная крыша
웅크리다	сильно сжимать; поджимать; 몸을~ съёживаться; 고양이가 웅크린 채 자고 있다 Кошка спит свернувшись.
그림자	тень; отражение; след; отпечаток; тень; ~의 теневой; 물에 비친 나무의 ~ отражение дерева в воде; 슬픔의 ~ тень грусти; 수상한 사람의 ~ тень сомнительного человека; ~를 감추다 бесследно исчезать; скрывать следы; ~가 지다 мрачнеть; становиться угрюмым; 제 ~에 놀라다 испугаться собственной тени; 창에 ~가 비쳤다 В окнах мелькали тени.; ~ 하나 얼씬하지 않는다 Ни души не видать.
풍기다	распространяться; испускать; вонять чем; 냄새를 ~ издавать (разносить) запах; 향기로운 라일락 냄새가 방으로 풍겨왔다 В комнату струился аромат сирени.; 차(茶)에서 비린내가 ~ чай воняет рыбой
슬슬	незаметно; слегка; не спеша; втихомолку; украдкой; ~ 걸어가다 брести; ~ 다가가다 подходить украдкой; 눈이 ~ 녹고 있다 Незаметно тает снег.; ~ 어루만지다 слегка поглаживать
캄캄하다	pitch-dark; <as> dark as pitch;
붕	выход газа или газообразного вещества
골짜기	ущелье; долина; овраг; лощина
골	1.ущелье; долина; овраг; 2.паз; 3. пробор; 4. округ; уезд; ~을 내다 делать паз на чем; ; 골 ; вспышка гнева; ~을 내다 сердиться; волноваться; ~이 나다 вспылить; ~이 오르다 выходить из себя; ; 골 ; мозг; голова; ~아픈 일 хлопотное дело; ~이 비다 бестолковый; тупой; глупый; ; 골 англ. goal; 1. ворота; финиш; 2. гол; попадание мяча в корзину; ~을 얻다 забить гол; ~을 지키다 стоять в воротах; 세 ~차로 이기다 победить (проиграть) со счётом 3:0; ~라인 линия ворот; ~키퍼 вратарь; ~킥 удар по воротам; ~포스트 штанга
울퉁불퉁	~하다 неровный; бугристый; ухабистый
비치	備置; ~하다 приготовить заранее; 무전 장치를 ~하다 приготовить передающее устройство
파묻히다	быть закопанным (зарытым); быть скрытым; 집은 꽃 속에 파묻혔다 Домик тонет (утопает) в цветах.
살펴보다	рассматривать; разглядывать; 지도를 ~ рассматривать карту
촛불	пламя (огонь) свечи
비추다	освещать; озарять; просвечивать (что-л. лучами); отражаться; быть отражённым; 전등으로 어구운 구석을 ~ освещать фонарём тёмные уголки; 가로등이 잠시 비추더니 꺼져버렸다 Фонари посветили и потухли.
유유히	спокойный; неторопливый наречие
대담	大膽; ~ 성 смелость; отвага; дерзость; ~스럽다; ~하다 смелый; отважный; дерзкий; 대담무쌍하다 бесстрашный; беспримерно отважный; ; 대담 對談; беседа; ~하다 беседовать; 격의 없는 задушевный разговор
무쌍	無雙; ~하다 беспримерный; небывалый; несравненный; не имеющий себе равных; 용감 ~하다 беспримерно отважный
쫓기다	be pursued[chased] (after);
정사각형	正四角形; квадрат
번쩍	with a flash.
전등	電燈; (электрическая) лампа
반사	反射; отражение; отблеск; отсвет; рефлекс; ~하다 отражаться; рефлектировать; ~적 рефлекторный; ~ 현미경 рефлекторный микроскоп
깜빡	~하다 1. мерцать; 2. мигать; моргать глазами; 3. внезапно потерять сознание (память); 깜빡임 мерцание; мигание; моргание; 눈 까빡 (깜짝) 할 사이도 없이 не успеть глазом моргнуть; 눈 하나 깜빡 안하다 глазом не моргнуть; 멀리서 불빛이 깜빡였다 Вдали мерцал огонёк.
채다	채다 догадываться; замечать (что)
돌담	каменная ограда
훌쩍	~ 들이마시다 пить залпом; втянуть в себя; ~ 뛰다 подпрыгивать; ~ 뛰어오르다 вскакивать
꾸러미	свёрток; пакет; ~의 пакетный; ~로 싸다 завернуть в пакет; 작은~ пакетик; 책~ свёрток с книгами
통닭	a whole chicken;
삐죽	~하다 острый; ~한 칼 острый нож
손짓	жест; знак; жестикуляция; ~하다 делать жест (знак); жестикулировать; 그는 내게 오라는 ~을 했다 Он сделал мне знак подойти к нему; Он жестом подозвал меня.
몸짓	(тело)движение; жест; движение; упражнение; ~ 언어 язык жестов
휘두르다	размахивать; распоряжаться; помыкать; ошеломить; проявлять; обнаруживать
그야말로	в самом деле; действительно; ~ 아름답다 Действительно красиво.; ~ 크다 Действительно большой.; 그렇다면 ~ 기쁘다 Если так, то я буду несказанно рад.; ~ 보람있는 일이다 Это действительно стоящая работа.
넘어지다	падать; валиться; провалиться; потерпеть неудачу; 맨땅에 ~ падать на землю ; 나는 하마터면 넘어질 뻔 했다 Я чуть не упал.
화풀이	火－; ~하다 срывать зло (сердце)
뒹굴다	валяться
무성	無聲; беззвучный; немой; безголосый; ; 무성 茂盛; ~하다 густой; становиться густым; густо расти; 언덕에는 풀이 ~하였다 На холмах росла густая трава
남매	男妹; брат и сестра; братья и сестры; 다정한 ~ дружные братья и сестры
연인	戀人; возлюбленный; возлюбленная; 한 쌍에 ~ влюблённая пара; влюблённые
떠오르다	подниматься; всплывать на поверхность; всходить; всплывать; приходить в голову
주워듣다	подслушивать; нечаянно слышать; 주워들은 이야기 нечаянно подслушанный разговор
짓씹다	chew thoroughly;
꿀꺽꿀꺽	gulping(ly)
쿨룩거리다	кашлять
조마조마	тревожно; беспокойно; нервно; неудобно; ~하게 하다 приводить кого в волнение; смущать; приводить в смятение; не давать покоя кому; вызывать тревогу у кого; взбудораживать кого; ~거리다 тревожиться о чём; ощущать тревогу (беспокойство); волноваться; не знать покоя; не находить себе места; принимать близко к сердцу что; сидеть, как на иголках
흔들거리다	колыхать(ся); слегка раскачивать(ся); дрожать; потрясать(ся); потряхивать(ся); мерно покачиваться; мерно колебать(ся); шатать(ся); сотрясаться; ходить ходуном; 발을 ~ болтать ногами
동정	動靜; движение; состояние; поведение; действие; ; 동정 同情; сочувствие; сострадание; ~ 어린 눈으로 바라보다 смотреть глазами, полными сострадания; ~하다 сочувствовать; испытывать сочувствие к кому-л.; 남의 불행을 ~하다 испытывать сочувствие к чужому горю; принимать участие в чужом горе; ~하여 из сострадания; из жалости
어서	скорее; живее; пожалуйста
자취	след; ~를 감추다 заметать следы; ~를 남기다 оставлять следы; ~없이 사라지다 скрыться в неизвестном направлении; бесследно исчезнуть; ~를 밟다 идти по следу; ; 자취 自炊; ~하다 самому себе готовить (пищу)
나동그라지다	tumble down[over]; topple over[down]; fall on one's back;
희생자	犧牲者; жертва; потерпевший; ~를 내다 понести жертвы; иметь потерпевших
아깝다	жалеть; жаль; жалко; 당신을 위해서라면 난 아무것도 아깝지 않다 Для вас мне ничего не жаль.; 시간이 ~ жаль времени; 이렇게 좋은 물건을 팔기가 ~ жалко продавать такую хорошую вещь
온통	всё целиком
투성이	기름~ весь в масле; 피~ весь в крови; 온통 사람 ~이다 быть многолюдным (заполненным людьми)
떨어뜨리다	ронять; сбрасывать; снижать; понижать; склонять
껴안다	1. обнимать; 2. брать на себя несколько дел; 꽉~ душить в объятиях; 몇몇 일의 책임을 ~ брать на себя ответственность за несколько дел; 아이를 ~ обнимать ребёнка
분해	分解; разложение; распад; расщепление; ~하다 расщеплять; разлагать; разбирать; демонтировать; 기계를 ~하다 разбирать машину; 총을 ~하다 разбирать ружьё; 비행기가 공중 ~되었다 Самолёт развалился в воздухе.
헤다	1. плавать; плыть; 2. споласкивать; полоскать; 빨래를 ~ полоскать бельё
제복	制服; (установленная) форма; форменная одежда
낯익다	знакомый; привычный; 그는 내게 낯익은 것 같다 Его лицо мне кажется знакомым.
소독약	消毒藥 antidot
쓰라리다	ныть; жечь; тяжёлый; трудный; горький; 가슴이 ~ сердце (душа) ноет; 쓰라린 경험 горький опыт
총소리	銃－; звук ружейного (винтовочного) выстрела; ружейный (винтовочный) выстрел
수레	телега; повозка; ~바퀴 колесо повозки
버럭	suddenly; abruptly; (all) of a sudden;
단호	斷乎; ~하다 решительный; категорический; непоколебимый; 단호히 решительно; категорически; непоколебимо; наотрез; 단호히 거절하다 отказать наотрез
주춤	~하다 резко остановить(ся); нерешительно двигаться; колебаться; не решаться
내보내다	выпускать; высылать; отправлять; выбрасывать; выгонять; выселять; выдворять; 담배 연기를 코로 ~ пускать дым через нос; 대표단을 국제회의에 ~ отправлять делегацию на международную конференцию; 마을에서 ~ выселять из деревни; 직장에서 ~ выгонять с работы
끙끙	with groans[moans];
심문	審問; допрос; расследование; ~하다 допрашивать; вести допрос; расследовать; проводить следствие; ~을 받다 быть на допросе; подвергаться допросу
장딴지	икры (ноги)
스치다	слегка задевать (касаться); скользить; промелькнуть; 시원한 바람이 얼굴을 스친다 Свежий ветер скользит по лицу.; 총알이 어깨를 스쳤다 Пуля слегка задела плечо.
출혈	出血; кровотечение; кровоизлияние; ~하다 кровоточить; кровь течёт; ~을 멈추게 하다 останавливать кровотечение; ~성 소인 геморрагический диатез; ~성 폐혈자 пастереллёз
충격	衝擊; ~하다 нападать (наносить) удар; ; 충격 衝激; потрясение; шок; удар; сотрясение; столкновение; отдача; толчок; импульс; ~적 ужасающий; возмутительный; потрясающий; шокирующий; импульсивный; импульсный; ~하다 сталкиваться; ударять; отдавать; толкать; служить импульсом; ~을 받다 пережить удар; быть потрясённым; испытать шок; быть в шоке; 그의 죽음은 모두에게 ~을 주었다 Его смерть потрясла всех.; ~적인 사건 потрясающее событие
절단	切斷; отрез(ание); разрез(ание); ~하다 отрезать; разрезать; ампутировать
돋우다	1. поднимать; повышать; стимулировать; усиливать; 식욕을 ~ возбуждать аппетит; 2. приподнимать; припускать; 3. злить; разжигать (ссору и т.п.); 부아를 ~ нервировать
내뱉다	выплёвывать; бросаться словами; изрыгать проклятия; 가래침을 ~ выплёвывать слюну с мокротой (слюну); 욕설을 툭~ бросаться ругательными словами
용기	勇氣; смелость; мужество; отвага; храбрость; доблесть; ~있는 мужественный; смелый; храбрый; ~없는 несмелый; робкий; трусливый; ~를 보이다 показывать присутствие духа; выказывать мужество; ~를 잃다 падать духом; терять мужество; ~를 주다 придавать кому мужество; воодушевлять кого; ; 용기 容器; вместилище; посуда; ; 용기 用器; инструмент; принадлежности; (нужные) вещи
데다	1. обжигаться чем; 덴 자리 место ожога; 끓는 물에 손을 ~있다 обжег руку кипятком; 2. потерпеть неудачу
원한	怨恨; злоба; негодование; ~을 사다 нажить себе врага; ~을 품다 питать злобу против кого
밀수	密輸; контрабанда; ~하다 заниматься контрабандой
지름길	кратчайший (прямой) путь; дорога напрямик; 성공에의 ~ кратчайший путь к успеху; 서울로 빠지는 ~ кратчайший путь, ведущий в Сеул; 우린 ~로 왔다 Мы ехали прямой дорогой
탄식	歎息·嘆息; вздох; сожаление; ~하다 вздыхать с сожалением
수배	手配; расстановка; расположение; ~하다 расставлять; располагать
진술	陳述; изложение; высказывание; показание; ~하다 излагать; высказываться о чём
분노	忿怒·憤怒; гнев; негодование; ~하다 негодовать; гневаться
가라앉히다	1. топить; погружать; 2. успокаиваться, успокоиться
고집	固執; упрямство; настойчивость; ~스럽다 казаться упрямым (неуступчивым; непокладистым); ~스레 упрямо; настойчиво ; ~하다 упрямиться; настаивать на своём; ~불통 упрямый как осёл; ~을 부리다 упрямиться; ~(을) 세우다 упорно стоять на своём
호주	戶主; глава семьи
호송	護送; конвоирование; эскортирование; сопровождение; охрана; ~하다 конвоировать; эскортировать
승용차	乘用車; легковой автомобиль; легковая машина
벼랑	пропасть; обрыв; отвесный склон; крутой обрыв; ~길 обрывистая дорога
털가죽	fur
집사람	моя жена
서재	書齋; (рабочий) кабинет
호화	豪華; роскошь; великолепие; пышность; ~하다 роскошный; пышный; великолепный
활활	~ 날다 плавно парить; ~ 타오르다 пылать; ~ 부치다 энергично обмахиваться; ~벗다 сбрасывать
타오르다	вспыхивать; воспламеняться; разгораться
사양	辭讓; 1. уступка; ~하다 уступать; 2. вежливый отказ; ~하다 вежливо отказываться; отклонять
소시민	小市民; мещанин; ~적 мещанский; ~계급 мещанское сословие; ~근성 мещанская идеология; мещанство
어설프다	неплотно пригнанный; неряшливый; грубый; небрежный; легкомысленный
모금	глоток; затяжка; 단~에 마시다 выпить залпом; ; 모금 募金; денежное пожертвование; сбор пожертвований; ~하다 добывать деньги
말씨	манера говорить; интонация
위압	威壓; властность; давление; нажим; запугивание; ~적 властный; повелительный
공손	恭遜; ~하다 скромный и почтительный; ~스럽다 казаться скромным и почтительным; ~하게 скромно и почтительно
악몽	惡夢; кошмар; страшный сон; ~같은 кошмарный; ~같은 광경 кошмарное зрелище; 그는 밤마다 ~에 시달린다 По ночам его мучают кошмары.
도중	途中; 1. по дороге; по пути; проездом; проходом; мимоходом; на полдороге; на полпути; 집으로 가는 ~에 по дороге домой; 2. в ходе; в процессе; 강의 ~에 в ходе лекции
상대편	相對便; другая (противоположная) сторона; 나는 ~편의 계획을 파악했다 Я раскусил планы противника.
염려	念慮; забота; озабоченность; беспокойство; ~스럽다 озабоченный; обеспокоенный; ~하다 беспокоиться; заботиться о ком-чём; ~마시게 Не беспокойтесь
여유	餘裕; излишек; избыток; великодушие и уравновешенность; спокойствие духа; ~(가) 있다 не торопиться; свободный духом; ~도 없다 нет ни минуты лишней; ~없는 생활 жизнь с ограниченными возможностями (средствами); ~시간 свободное время
즉	卽; то есть; а именно
시각	時刻; время; час; момент; минута; ~을 다투다 нуждаться в неотложных мерах; 약속된 ~ обещанная минута
자그맣다	자그마(하다)
품다	носить за пазухой; обнимать; прижимать к груди; таить в душе что; питать (чувство); высиживать птенцов; прикрывать крыльями птенцов; 희망을 ~ лелеять надежду; 애정을 ~ питать любовь
넋	душа; дух; 애국의 ~ патриотический дух; ~을 놓다 растеряться; оторопеть; ~을잃다 падать духом; потерять сознание; ~이 나가다 обезуметь; ~이 빠지다 души не чаять (в ком)
연신	連信; подряд; непрерывно; всё время
종합	綜合; синтез; обобщение; ~의 синтезированный; ~적 синтетический; комбинированный; комплексный; ~하다 синтезировать; обобщать; ~병원 поликлиника; ~예술 общее искусство
기대다	1. опираться; прислоняться; покоиться; 기대어 앉다 сесть, прислонившись к чему; 지팡이에 ~ опираться на трость; 책상에 ~ прислоняться к столу; 2. надеяться на; быть уверенным; полагаться; рассчитывать на кого-либо; зависеть от кого-либо
앙갚음	месть; возмездие; ~하다 мстить кому за что
진정	眞情; настоящее (подлинное) чувство; искренность; ~하다 искренний; подлинный; настоящий; ; 진정 眞正; подлинность; истинность; ~하다 подлинный; истинный; ; 진정 進呈; ~하다 дарить; преподносить; 아버지는 우리에게 끊임없이 무엇가를 ~하신다 Отец постоянно дарит нам что-нибудь.; ; 진정 鎭靜; успокоение; умиротворение; смягчение; ~하다 успокаивать; умиротворять; усмирять; ~시키다 уменьшать раздражение; смягчать; успокаивать; ; 진정 陳情; ходатайство; прошение; просьба; петиция; ~하다 подавать петицию (ходатайство; прошение); ходатайствовать; 서면으로 ~하다 изложить на бумаге
난롯불	огонь камина
단지	небольшой кувшин; 꿀~ кувшин меда; ; 단지 但只; только; лишь; однако; тем не менее; даже; по крайней мере; хотя бы; ~ 1분만 있으면 Минутку.
지휘	指揮; команда; руководство; управление; ~하다 руководствовать; управлять; дирижировать; ~하에 있다 находиться (быть) под руководством кого; под командой кого; ~를 맡다 принимать на себя командование; ~에 따라 по команде; 바이얼리니스트의 ~로 под управлением скрипача; ~계통 порядок подчинённости
단순	單純; простота; ~하다 простой; простодушный; несложный; ~히 просто; ~한 사람 простодушный человек; ~한 호기심 простое любопытство; ~화 시키다 упрощать
간섭	干涉; 1. вмешательство; интервенция; 외부의 ~ вмешательство извне; 무력 ~ вооруженное (военное) вмешательство; 불~주의 политика невмешательства; ~을 받지 않다 свободный от вмешательства; ~하다 вмешиваться; 내정을 ~하다 вмешательство внутренние дела; 사생활을 ~하다 вмешиваться частную жизнь; 2. интерференция
종종	種種; иногда; порой; подчас; в отдельных (некоторых) случаях; от случая к случаю; время от времени; временами; иной раз; эпизодически; при случае; кое-когда; нет-нет да и ...; ~ 나는 두통을 앓는다 У меня иногда побаливает голова.
커녕	какое там; куда там; не то что; не только..., но даже; 나무는~ 풀도 없다 Не только деревьев, но даже травы нет.; 비는~ 안개도 안 내린다 Какой там дождь, даже облачка нет.; 이 책은 유익하는~ 매우 해롭다 Эта книга не только не полезна, но даже очень вредна.
털어놓다	выкладывать; открывать; вытряхать; 털어놓고 말하면 откровенно говоря; 비밀(음모)을 ~ открывать тайну (заговор)
모친	母親; мать
조르다	1. крепко затягивать (завязывать); затянутый; 허리띠를 ~ затягивать пояс потуже; 2. приставать к кому (с просьбой); выпрашивать; клянчить что у кого; доставать кого; докучать кого чем; 돈을 꾸어달라고 ~ выпрашивать деньги у кого; 집요하게 ~ настойчиво требовать; 성가시게 ~ стоять над душой
즉시	卽時; немедленно; незамедлительно; сразу же; ~불 немедленная уплата
면회	面會; приём; личная встреча; свидание; ~하다 принимать (кого); лично встречаться (видеться)
교제	交際; дружеские отношения; общение; ~하다 вступать в дружеские отношения с кем; общаться с кем; завязывать знакомство; ~가 넓다 иметь широкий круг знакомых
바래다주다	провожать
곧잘	довольно хорошо; прилично
상속	相續; наследование; ~하다 наследовать; 아버지의 재산을 ~하다 наслёдовать имущество отца
잡초	雜草; сорняк; сорная трава; бурьян; 밭의 ~를 뽑다 полоть сорную траву на поле
우거지다	густо расти; густеть; 뜰에는 잡초가 우거져 있다 В саду густо растёт трава.
소용	所用; польза; надобность; ~ 되다 нужный; полезный; иметь надобность; ~없다 ненужный
쥐죽은듯	тихий, как мышь; притаившись, как мышь
밀려오다	надвигаться; нахлынуть
작별	作別; расставание; прощание; ~하다 расставаться; прощаться; ~인사를 하다 прощаться
아쉽다	недоставать кого-либо, чего-либо кому-либо; не хватать; обидный; 아쉬운 실수 обидный просчёт; 그는 개가 죽어서 몹시 아쉬워한다 Он скучает по умершей собаке.
휘둥그레지다	open <one's eyes> wide
우두커니	рассеянно; безучастно; бездумно; ~바라보다 рассеянно смотреть
뒷모습	(внешний) вид сзади
군데군데	here and there; sporadically
뭉치다	образовываться; свёртываться; комкать; скатывать; лепить; сплачивать(ся); смыкать(ся)
시커멓다	очень чёрный; чёрный-пречёрный
휘젓다	1. мешать; размешивать; 2. махать; размахивать; 3. расстраивать; приводить в беспорядок
의혹	疑惑; сомнение; недоверие; подозрение; ~을 품다 подозревать; иметь подозрения против кого; ставить под сомнение; ~을 풀다 рассёять сомнение (подозрение); ~을 사다 навлечь на себя подозрение; быть под подозрением
무사히	無事-; спокойно; благополучно; без проблем
혼란	混亂; смятение; беспорядок; хаос; смута; расстройство; паника; ~하다 (형) хаотичный ; беспорядочный; ~하다 (동) быть в беспорядке; быть в хаотическом состоянии; ~되다 находиться в смятении; впасть в смятение; ~을 일으키다 приводить в беспорядок; вносить анархию; ~이 일어났다 Поднялась (началась) смута.; ~상태 хаотичность; путаница
꾸미다	1. украшать; декорировать; 2. шить; 3. притворяться кем-либо; врать; приукрашивать; 4. составлять; организовывать; 5. задумывать; замышлять; 꾸미지 않은 безыскусственный; бесхитростный; незатейливый; 꾸밈 затея; 꾸미지 않고 без затей (украшения); 문서를 ~ составлять документ; 방을 꽃으로 ~ украшать комнату цветами; 아픈 척 ~ притворяться больным; 음모를 ~ замышлять заговор; 이불을 ~ шить одеяло
합세	合勢; объединение сил; ~하다 объединять силы; объединяться; присоединяться к чему; ...과 ~하여 во взаимодействии с кем-чем
본받다	本－; следовать примеру
싸이다	быть охваченным; уметь ладить с кем-чем
상쾌	爽快; ~하다 бодрый; весёлый; свежий; ~한 기분 весёлое настроение
잡담	雜談; пустая болтовня; ~하다 вести пустой разговор; попусту болтать
출세	出世; успех в жизни; карьера; ~하다 делать карьеру; преуспевать
자재	自在; ~하다 свободный; ничем не ограниченный (стесненный); ~적 в себе; ~적 사물 вещь в себе; ; 자재 資材; материал; ~공급 материальное обеспечение; 건축~ строительные материалы
택하다	擇－; выбирать; избирать; отбирать; предпочитать кого-что кому-чему
생김새	вид; внешность; ~로 판단하다 судить по внешности; 아름다운 ~ красивая внешность
경대	鏡臺; трюмо
반짝이다	сверкнуть; блеснуть; мерцать; 별들이 반짝인다 Звёзды мерцают.
해수욕장	海水浴場; морской курорт; пляж
평범	平凡; ~하다 заурядный; банальный; посредственный; простой; ~히 заурядно; незаметно; посредственно; ~하게 일생을 보내다 жить и умереть незаметно; заурядно прожить свою жизнь
향수병	пузырёк духов
장미	薔薇; роза; 들~ дикая роза
조화	調和; гармония; соответствие; согласие; созвучие; благозвучие; слаженность; симметрия; ~된 гармоничный; гармонический; созвучный (кому-чему); ~시키다 гармонировать; соответствовать кому-чему; согласовываться с кем-чем; приводить в соответствие (с чем); 언행은 ~를 이루다 слова гармонируют с поступками; ; 조화 造化; созидание; творение; чудо; игра природы; диво; невидаль; ~로운 дивный; изумительный; сверхъестественный; ~를 부리다 творить чудеса; ~로운 일 восьмое чудо света; ~의 신 создатель; творец; ; 조화 造花; искусственные цветы
십자가	十字架; 1. крест; распятие; 2. перекрёсток; 우리가 있는 곳을 알기 쉽게 지도 위에 ~ 표시를 하시오 Отметьте на карте крестиком то место, где мы находимся.
축제일	фестивальный день
사격장	射擊場; стрельбище; полигон; тир
표적	標的; мишень; цель; метка; знак; 과녁의 ~ яблоко мишени; ~이 되다 служить миш-ёнью; ~에 맞다 попасть в цель; ; 표적 表迹; знак; след чего
사격	射擊; стрельба; обстрел; огонь; ~을 개시하다 открыть стрельбу; ~하다 стрелять; 목표를~ 하다 стрелять в цель; 사격장으로 ~ 하러 가자 Пойдём постреляем в тире; 적군들이 주기적으로 서로에게 ~을 가했다 Противники периодически обстреливают друг друга; ~경기 стрелковые состязания; ~부대 стрелковый полк; 조준~ прицельная стрельба; 직접~ стрельба прямой наводкой
개머리판	приклад ружья
포즈	pose; поза; ~를 취하다 позировать; принимать позу
상상	想像; воображение; представление; ~하다 представлять; воображать; ~의 воображаемый; 밝은 미래를 ~하다 представлять светлое будущее
뒷면	－面; задняя сторона; 사건의 ~ обратная сторона события
되풀이	повторение; ~하다 повторять; ~되다 повторяться
구기다	1. мять(ся); морщить(ся); комкать(ся); 2. не ладиться; не клеиться
내주	來週; следующая (будущая) неделя; ~에 на следующей (будущей) неделе
성대	盛大; великолепие; ~하다 торжественный; строгий; великолепный; роскошный; ; 성대 聲帶; тембр голоса; голос; ~묘사 имитация голоса
축하회	祝賀會; чествование
대금	代金; плата; цена; ~지불 능력이 있는платежеспособный; 현금으로 ~을 결제하다 платить наличными; ~지불 платеж; ~지불 능력 платежеспособность; ; 대금 大金; крупная сумма; большие деньги; ; 대금 貸金; ссуда
치르다	платить; расплачиваться; переносить; претерпевать; совершать; выполнять; проводить; устраивать; принимать пищу
갚다	возвращать (долг); отплачивать; возмещать; квитаться; искупать;  빚을 ~ возвращать долг; 죄를 ~ искупать грех; 다 ~ выплачивать
속력	速力; скорость; ход; ~의 скоростной; ~을 내다 (가하다) набирать (развивать; увеличивать) скорость (ход); ~을 낮추다 сбавлять (уменьшать; замедлять) скорость (ход); ~이 떨어지고 있다 скорость падает; ~이 빠른 자동차 быстрая (скоростная) машина; 전~으로 полным ходом; 최대~ максимальная скорость
범선	帆船; парус; ~을 타고 세계 일주를 할 계흭이다. Планировать путешествие вокруг света на парусной лодке.
돈벌이	заработки
발코니	balcony; балкон
정돈	整頓; приведение в порядок; уборка; ~하다 приводить в порядок
매상	買上; = 수매(收買); ; 매상 賣上; продажа; сбыт
베끼다	переписывать; списывать; 친구의 받아쓰기를 몰래 ~ списать диктант у товарища; 교과서를 베껴 쓰세요! Спишите из учебника!
메우다	заполнять; засыпать; затыкать; заделывать
노크	англ. knock; стук ; ~하다 стучать(ся); 방문을 ~하다 стучаться в дверь
공모	公募; ~하다 объявлять о приёме на работу (набор); продавать акции; собирать пожертвования; ; 공모 共謀; сговор; заговор; ~하다 вступать в сговор; ...와 ~하여 в сговоре с кем; ~자 сообщник; соучастник; заговорщик
정오	正午; полдень; ~에 в полдень
붙잡다	крепко держаь(ся); схватиться; схватывать; 손잡이를 ~ схватиться за рукоятку
휘날리다	1. развевать(ся); кружить(ся) (в воздухе); 2. мести (о метели); 3. прославлять; делать широко известным
찬란	燦爛; блеск; ослепление; ~한 ослепительный; блестящий; глянцевитый; выдающийся; роскошный; 나는 그녀의 ~한 아름다움에 눈이 부셨다 Она ослепила меня своей красотой.; 별이 ~히 빛난다 Звёзды сверкают.
녹이다	растапливать; расплавлять; растворять; согревать; отогревать; измучить; довести до изнеможения; обвораживать; очаровывать; увлекать (кем-чем); 고문을 하여반 죽을 정도로 녹여 버리다 измучить (кого) пытками до полусмерти; 난롯가에서 손을 ~ согревать руки у пёчки; 무쇠를 ~ расплавлять чугун; 미모로 남자들을 ~ обвораживать мужчин красотой ; 설탕을 물에 ~ растворять сахар в воде
열기	熱氣; горячий (жаркий) воздух; жар; высокая температура; пыл; рвение
내뿜다	выпускать; извергать; извергаться; 화산에서 용암이 내뿜어졌다 Лава извергалась из вулкана; 화산이 용암을 내뿜는다 Вулкан извергает лаву.
양지쪽	陽地－; солнечная сторона
수도원	修道院; монастырь; монастырский; 남자 ~ мужской монастырь; 여자 ~ женский монастырь; 대~ лавра
야위다	худеть; быть худощавым; терять в весе; спадать с тела (с лица)
번뜩이다	вспыхивающий; 눈빛이 ~ Вспыхивающий взгляд.
편찮다	uncomfortable; uneasy.
신장병	腎臟病; заболевание почек
넘치다	переливаться через край; переходить; превышать; переваливать; быть переполненным (чем); бить через край; 분에 넘치는 사치 роскошь не по средствам; 기쁨이 넘친다 Веселье бьёт через край.; 강물이 넘쳤다 Река выштла из берегов; 그녀의 얼굴은 기쁨에 넘쳤다 Её лицо было переполненно радостью
채다	1. получать пинок (удар ногой); 2. замечать; понимать; догадываться; красть; тащйть; выхватывать; дёргать; тянуть; тащить рывками
행인	行人; путник; прохожий
잡히다	находиться в руках; быть выбранным (намеченным); быть сделанным; быть погашенным; быть взятым (захваченным, схваченным); быть обнаруженным (найденным)
납빛	gray, leaden
사로잡히다	быть пойманным живым (взятым в плен); быть захваченным; 원수에게 ~ быть взятым в плен
알리바이	alibi; алиби; 자기의 ~를 내세우다 доказать (установить) своё алиби
장례식	葬禮式; похоронный обряд; похороны
정체불명	unknown personality
단독	單獨; отдельный; сепаратный; ~으로 сам один; отдельно; ~선거 сепаратные выборы
연관	煙管; связь; ~되다 связанный с кем-чем
싸매다	обвязывать; обматывать (вокруг чего); наматывать; 머리를 수건으로 ~ обматывать голову полотенцем; 붕대로 상처를 ~ бинтовать рану
킬로그램	кг
체중	體重; вес тела; ; 체중 體重; весы
줄다	уменьшаться; сокращаться; снижаться; сжиматься; убавляться; редеть; садиться (об одежде); 강물이 줄었다 река обмелела; 고무는 온도에 따라 늘거나 준다. Резина увеличивается и уменьшается в объеме в зависимости от температуры.; 이것은 빨아도 줄지 않는다. Эта вещь не садится после стирки.; 수익이 줄었다. Доход снизился.
붉어지다	краснеть; 얼굴이 붉어진다 лицо краснеет
반짝거리다	сверкать; блестеть; мерцать
실제로	實際－; действительно; в действительности
허용	許容; допущение; разрешение; позволение; ~하다 допускать; разрешать; позволять; санкционировать; ~ 오차 допустимая ошибка; допустимое отклонение
처넣다	с силой впихивать (всовывать); набивать; вложить во что; 책을 상자에 ~ набивать коробку книгами; 돈을 증권에 ~ беспрестанно вкладывать деньги в акции
벅차다	непосильный; переполненный; кипучий; напряжённый; 하루에 끝내기는 ~ Закончить за один день непосильно; 가슴 벅찬 감격чувство, переполняющее грудь
저지르다	совершать; допускать; 실수를 ~ совершать (допускать) ошибку; 범죄를 ~ совершать преступление
앙칼지다	резкий; яростный; настойчивый
알아듣다	понимать; расслышать
드레스	платье
야단	惹端; шум; гам; скандал; беда; неприятности; ругань; скандал; ~나다 расшуметься; случиться; ~치다 поднимать шум; ругаться; ~하다 шуметь; ругаться
보석	保釋; ~하다 освобождать под залог (на поруки); ; 보석 寶石; драгоценный камень
치장	治粧; ~하다 нарядиться; разодеться; красиво обставить (комнату); ~거리 предмет украшения; украшение
짙다	1. оставаться в достаточном количестве; 2. очень густой; глубокий (о темноте)
금새	price
상냥	~하다 милый; ласковый; приветливый; 마음이 ~한 사람 ласковый (приветливый) человек
죄인	罪人; преступник; уголовник; правонарушитель; грешник; 상습적인 ~ злостный преступник; рецидивист
나부랑이	лоскут, клочок; 관리 ~ мелкий чинуша; 장교 ~ офицеришка; 종이 ~ клочок бумаги
야영	野營; лагерь; бивак; ~하다 стоять на биваках (биваком); располагаться лагерем
끌리다	1. тянуть; тащить; 범인이 현장에서 붙들려 경찰서로 끌려갔다 Преступник был поймат с поличным и отправлен в полицию.; 2. тащиться; волочиться; 치마가 끌리다 Ее платье волочилось по полу.
밧줄	верёвка; тонкая верёвка; ~의 верёвочный; ~을 매다 крепить канат; ~ 사닥다리 верёвочная лестница
묶이다	быть связанным (перевязанным)
나르다	возить, перевозить; носить; переносить; 트렁크를 방안으로 ~ переносить чемодан в комнату
몽유병	夢遊病; сомнамбулизм; лунатизм; ~자 лунатик
치열	治熱; ~하다 снимать жар (температуру); ; 치열 熾烈; ~하다 резкий; ожесточённый; яростный; ; 치열 熾熱; ~하다 жаркий; ожесточённый; высокий; ; 치열 齒列; ряд зубов; зубы
격투	格鬪; рукопашная схватка; драка; ~하다 драться; вступать в рукопашную схватку; ; 격투 激鬪; ожесточённая борьба; жаркая схватка; ~하다 участвовать в жаркой схватке
제각기	－名其; каждый в отдельности
헛기침	притворный кашель; покашливание; ~하다 кашлянуть
솜씨	умение; мастерство; сноровка; ловкость; ~ 있는 искусный; сноровистый; ловкий; ~ 있게 мастерски; с большим искусством (мастерством); ~를 보이다 показать мастерство (искусство); 그는 일을 처리하는 ~가 훌륭하다 У него отличное умение справляться с делом.
소문	所聞; молва; слух(и); ~ 나다 распространяться (о молве)
연안	沿岸; берег; побережье; ~의 береговой; прибрежный; каботажный; ~ 지대 прибрежный район; взморье; прибрежная полоса (местность)
항로	航路; рейс; морской путь; курс; воздушная линия (трасса); ~ 표식 навигационный знак
묘연	杳然; ~하다 неясный; неизвестный; нечёткий; неясно видимый
경비대	警備隊; охранные (пограничные) отряды
발각	發覺; раскрытие; ~되다 обнаруживаться; разоблачаться
몰수	沒收; экспроприация; конфискация; ~하다 экспроприировать; конфисковать; 무상 ~ безвозмездная конфискация (раздача); ~ 재산 конфискованное имущество
금주법	禁酒法; закон, запрещающий спиртные напитки
문지르다	гладить; натирать; вытирать; стирать
떨구다	ронять; сбрасывать; оставлять; иссякать; кончаться; снижать; понижать; 눈물을 ~ ронять слёзы
흐느끼다	всхлипывать
칼날	лезвие ножа; клинок
울부짖다	громко плакать; реветь; выть; 울부짖는 рёв; 바람이 울부짖는다 Ветер воет.; 어린아이들이 울부짖는다 Дети громко плачут.; 짐승이 사납게 울부짖는다 Зверь страшно ревет.
엄청나다	огромный; непомерный; страшный; невообразимый; громадный; 엄청나게 ужасно; страшно; очень; крайне; 엄청나게 큰 огромный; гигантский; исполинский
곁눈	~을 주다 (~질하다) скосить глаза; делать знак глазами; ~(을) 팔다 отвлекаться от чего
제의	提議; предложение; внесение; ~하다 предлагать; вносить предложение; ~되다 быть предложенным; ...의 ~로 по предложению кого; ~를 받아들이다 принимать предложение; ~를 거절하다 отклонять предложение; ; 제의 題意; смысл темы (заглавия)
몫	доля; часть; ...의 ~으로 되다 достаться (кому); ...의 ~으로 남겨두다 оставить на чью долю (для кого); 나의 ~만 지불했다 Я заплатил только за себя.; 자기 ~으로 만족하다 быть довольным своей частью
용돈	用－; карманные деньги; деньги на мелкие расходы
벌이	заработок; ~로 생계를 유지하다 заработать свой хлеб; 그는 ~가 좋다. Он хорошо зарабатывает.
회상	回想; воспоминание; ~하다 вспоминать
보조	步調; шаг; поступь; ~를 맞추다 подстраиваться под шаг; 공동 ~를 취하다 принимать общий шаг; ; 보조 補助; помощь; поддержка; ~적 служебный; дополнительный; вспомогательный; подсобный; подручный; помогающий; ~하다 помогать; оказывать (помощь; поддержку); 경비의 일부를 ~하다 покрывать часть расходов; 편집일을 ~하다 помогать в работе по редактированию
엔진	engine; машина; двигатель; мотор
대서양	大西洋; Атлантический океан
기도	企圖; попытка; замысел; намерение; ~된 задуманный; намеренный; ~하다 пытаться; делать попытку; намерен; намереваться; замышлять; ; 기도 氣道; дыхательные пути; ; 기도 祈禱; молитва; молебен; ~의 молитвенный; ~하듯이 молитвенно; ~하다 молиться; ~를 드리다 читать (творить) молитву; ~하러 가다 идти на молитву; 고인의 명복을 ~하다 молиться за упокой души умершего
출항	出港; выход в море из порта (из гавани); ~하다 уходить (выходить) из порта; ; 출항 出航; отправление в плавание; ~하다 отправляться в плавание
헤드라이트	передние фары
실루엣	англ. silhouette; силуэт; силуэтный
점차	漸次; постепенно; понемногу; мало-помалу; шаг за шагом
배반	背反•背叛; предательство; измена; ренегатство; ~의 предательский; ~하다 предавать; изменять; 친구를 ~하다 Предавать своего друга.
경비정	警備艇; сторожевой катер
강제	强制; принуждение; ~적인 принудительный; насильственный; ~적으로 принудительно; насильно; ~하다 принуждать; заставлять; вынуждать; ~ 노동принудительная работа; ~ 집행 принудительные меры; ~ 이주 депортация; ~ 접종 принудительная вакцинация
상륙	上陸; высадка на берег; десант; ~하다 высаживаться на берег; ~을 허가하다 разрешать высадку на берег
법정	法定; ~하다 определять, устанавливать законом; ; 법정 法廷; суд; трибунал; зал суда; судебное заседание; ~에 서다 предстать перед судом; 국제 국사~ международный военный трибунал; ~ 의사록 протокол судебного заседания
재판	再版; переиздание; второе издание; ~하다 переиздавать; ; 재판 裁判; суд; судебное разбирательство; ~하다 судить; ~비용 судебные издержки
판결	判決; определение; решение; приговор; ~하다 определять; решать; выносить приговор; ~을 유예하다 отложить вынесение приговора; 그는 무죄 ~을 받았다 Он был судом оправдан.
징역	懲役; каторга; каторжные работы; ~을 살다 находиться на каторге; ~살이를 보내다 сослать на каторгу; 무기~ пожизненная каторга
고용	雇用; наём; занятость; ~하다 нанимать; ~계약 соглашение (контракт) о найме; ~노동자 наёмный рабочий; ~조건 условия найма; 불완전~ неполная занятость; 완전~ полная занятость
마주하다	находиться лицом к кому; находиться друг против друга
노동	勞動; труд; работа; ~의 трудовой; рабочий; ~하다 трудиться; работать; 강제 ~ принудительный труд; 숙련 ~ квалифицированный труд; 육체 (정신) ~ физический (умственный) труд; ~가치설 теория трудовой стоимости; ~강도 интенсивность труда; ~계급 рабочий класс; ~귀족 рабочая аристократия; ~능력 трудоспособность; работоспособность; ~생산성 производительнось труда
지독	至毒; ~하다; ядовитый; едкий; злобный; ужасный; жестокий; ~한 말 колкая (едкая) речь; ~한 여자 злобная женщина; ~한 모욕 грубое оскорбление; ~한 구두쇠 ужасный скупец; ~한 추위 лютый холод; ~하게 공부하다 усердно учиться; ~한 감기에 걸리다 сильно простужаться; ~한 날씨 ужасная погода
중노동	重勞動; тяжёлый физический труд
수감	收監; заключение; арест; ~된 заключённый; арестованный; ~하다 подвергать тюремному заключению; взять под арест
면회실	面會實; приёмная
다스리다	управлять; ухаживать за чем; приводить в порядок; сдерживать; лечить; наказывать; расправляться с кем-чем; 나라를 ~ управлять страной; 병을 ~ лечить болезнь; 삼림을 ~ ухаживать за лесом; 자기 자신을 ~ владеть собой; 죄인을 ~ наказывать преступника
히죽거리다	довольно усмехаться; ухмыляться
분배금	分配金; распределяемая сумма
밀수품	密輸品; контрабандный товар; контрабанда
빼돌리다	спрятать; 빼돌려 둔 돈 спрятанные деньги
예컨대	例－; например; к примеру
손톱	ноготь; ногтевой; ~을 깎다 подрезать (подстригать) ногти; ~을 기르다 отращивать ногти; ~만큼도 вообще; совсем; ~만큼도 달라지지 않았다 Нисколько не изменилось; ~깎이 маникюрные ножницы
본국	本國; родина; эта (данная) страна; ; 본국 本局; департамент; управление (в противоп. отделению); это (данный) департамент; это (данное) управление
단속	團束; регулирование; управление; ~하다 контролировать; управлять; ~에 걸리다 попадать под контроль; 음주운전 ~을 하다 проверять водителей на наличие алкоголя в крови; ; 단속 斷續; прерывистый; спазматический; ~적으로 прерывисто; ~되다 прерываться
매입	買入; покупка; закупка; приобретение; ~하다 покупать; закупать; приобретать
모처럼	нарочно; специально; впервые (за долгое время)
협력	協力; взаимодействие; поддержка; сотрудничество; ~하다 сотрудничать; обьединять усилия; действовать совместно; поддерживать
상금	賞金; денежная премия
의논	議論; обсуждение; спор; дебаты; ~하다 бсуждать(ся); спорить; дебатировать
의견	意見; мнение; взгляд; точка зрения; ~을 진술하다 высказывать мнение
휘말리다	1. быть свернутым; 2. быть запутанным; быть впутанным; 3. быть поглощенным; быть втянутым; 그는 소용돌이 속에 휘말려 들어갔다 Его затянуло в водоворот.
음흉	陰凶; ~하다 подлый; гнусный; коварный; ~스럽다 казаться подлым (гнусным; коварным)
반드시	непременно; обязательно; безусловно
부풀다	ворситься; пушиться; опухать; вздуваться; вспучиваться; подходить; набухать; разбухать; быть довольным; 그의 마음은 기대에 부풀었다 Душа его переполнялась надеждой.; 빵이 제대로 부풀었다 Хлеб хорошо поднялся.
부르르	~ 떨다 дрожать мелкой дрожью
악당	惡黨; негодяй; мерзавец; злодей; бандит; ~의 злодейский
복수	復讐; месть; возмездие; реванш; ~하다 мстить; отплачивать; брать реванш; 지난 번 패배를 ~하다 отомстить за прошлое поражение; ~주의 реваншизм; ~주의자 реваншист; ; 복수 腹水; водянка брюшной полости; асцит; ; 복수 複數; комплексное число; множественное число
화신	化身; воплощение; олицетворение; ~하다 олицетворять; воплощать; ; 화신 花信; сообщение о цветах (цветении деревьев)
몸서리	дрожь; ~(가) 나다 леденить; коробить
비로소	только что; впервые; 그가 죽은 후에야 ~그의 가치를 깨달았다 Только после его смерти я осознал его настоящую ценность.
알아채다	догадываться
위반	違反; нарушение; ~하다 нарушать; идти против чего; идти вразрез с чем; 조약을 ~하다 нарушать договор; ~행위 правонарушение; преступное деяние; 교통법규~ нарушение правил уличного движения; 주차~ нарушение правил стоянки (машин)
곤봉	棍棒; дубинка; деревянная палка; ~체조 гимнастические упражнения с деревянной палкой
혐오감	嫌惡感; чувство отвращения
까다롭다	трудный; сложный; щекотливый; придирчивый; привередливый; 까다롭게 сложно; непросто; щекотливо; придирчиво; привередливо; 까다롭게 굴다 привередничать; 까다로운 질문 щекотливый вопрос; 까다로운 사람 привередливый человек
형기	刑期; срок наказания; ~를 복역하다 отбывать срок (наказания); ~를 마치다 отбыть срок
단식	單式; простой способ; одиночный разряд; ~경기 игры одиночного разряда; ~부기простая бухгалтерия; ; 단식 斷食; голодовка; голодание; ~하다 голодать; ~투쟁 голодная забастовка; голодовка
벌리다	1. образовывать (щель); 2. широко расставлять (раскрывать); 3. распростирать; разгребать; раскидывать
생지옥	生地獄; ад кромешный
밤새	в течение ночи; за ночь
지새다	рассветать; ночевать; 밤을 꼬박 ~ бодрствовать всю ночь; не спать нею ночь; 날을 새며 일하다 работать всю ночь напролёт; 날이 지샐 무렵이었다 чуть только забрезжило; 뜬눈으로 ~ глаз не смыкать; 지새는 달 тусклая утренняя луна
찔리다	проколотый; 양심이 ~ кого мучает совесть
한꺼번에	одновременно; сразу; за один раз; 모든 것을 ~ 하다 сделать всё сразу
주저앉다	плюхаться; тяжело садиться; опускаться; оседать; рушиться; разрушаться; обваливаться; проваливаться; 피곤한 모습으로 소파에 ~ устало опускаться на диван; 집이 ~ рушится дом; 다리가 주저앉았다 Мост обвалился.
찢기다	get torn
메스껍다	1. чувствовать тошноту; тошнить; 2. тошнотворный; отвратительный
지옥	地獄; ад; ~같은 адский; ~과 극락 ад и рай; ~에 떨어지다 попадать в ад; 생~ настоящий ад; 교통~ чертовские пробки; 시험 ~ мучительные экзамены
처참	悽慘; ужас; несчастье; нищета; жестокость; безжалостность; ~하다 ужасный; страшный; несчастный; печальный; скорбный; безутешный; ~한 전투 беспощадная борьба; ~한 이야기 страшная (ужасная) история; ~한 살인 чудовищное убийство; 자신을 ~하게 느끼다 чувствовать себя несчастным; ~한 모습을 하다 иметь жалкий вид; ~한 빈곤 крайняя нищета; ; 처참 處斬; ~하다 отрубать голову кому; обезглавливать
자칫	чуть-чуть; чуть было не; ~ 잘못하면 если ошибёшься
수포	水泡; пузырь; ~로 돌아가다 лопнуть как мыльный пузырь; пойти прахом
배회	徘徊; ~하다 бродить; слоняться; скитаться; 청소년들이 밤거리를 ~한다 Дети слоняются по ночной улице.
오로지	только; лишь; исключительно
유효	有效; эффект; годность; действенность; ~하다 действенный; имеющий силу; действующий; эффективный; ~기간 срок годности; ~ 숫자 значащая цифра
뻔뻔	~하다 наглый; ~스럽다 наглый
불끈	~하다 торчать; заметно выступать; сжать кулаки; ~ 화를 내다 серьёзно гневаться; 주먹을 ~ 쥐다 крепко сжимать кулаки; 근육이 ~ 솟다 напрягать мышцы
맹수	猛獸; хищный зверь
폭발	爆發; взрыв; разрыв; детонация; вспышка; ~적 (~의) разрывной; огромный; потрясающий; ~적인 인기 потрясающая популярность; ~하다 взрываться; детонировать; ~시키다 взрывать; произвести взрыв; 혁명이 ~하였다 Вспыхнула революция.; 화산의 ~ извержение вулкана
새빨개지다	краснеть; 술을 마시면 얼굴이 새빨개진다 Лицо краснеет от выпивки.
무덤	могила; гробница; 제 ~을 파다 рыть могилу самому себе
거세다	сильный; мощный; грубый; 거센 파도 мощная волна
약혼자	約婚者; помолвленный; жених
일가	一家; семья; родственники; стиль; школа; течение; ~의 семейный; домашний; ~천척 члены одного рода
친척	親戚; близкое родство; ближайшие родственники; родня; ~ 관계 родственные отношения
배짱	мысли; думы; настойчивость; упорство
약혼녀	約婚女; помолвленная; невеста
미궁	迷宮; лабиринт; тупик; ~에 빠지다 заходить в тупик
방아쇠	спусковой крючок; ~를 당기다 спустить курок
사정	事情; обстоятельства; положение дел; обстановка; ситуация; 가정 ~으로 по семейным обстоятельствам; ; 사정 射精; = 토정(吐精)
사소	些少; ~하다 незначительный; мелкий; ~한 일 때문에 걱정하다 беспокоиться из-за пустяка; ~한 금액 мелкая сумма; ~한 문제로 다투다 ругаться из-за мелкой проблемы; ~한 일로 욕설을 하다 разругаться из-за пустяка
파악	把握; ~하다 постигать; понимать; давать себе отчет в чем; схватывать; держать в руках; 의미를 ~하다 схватывать (понять) смысл; 사업의 진행을 ~하다 войти в курс дела
육감	六感; шестое чувство; ; 육감 肉感; чувственность; сладострастие; ~적 чувственный; сладострастный; соблазнительный; ~적인 아름다움 чувственная красота
잔재주	－才－; махинация; тонкое мастерство; умение; ~를 부리다 устраивать (проделывать) махинацию
화해	和解; примирение; мирное разрешение; компромисс; ~하다 мириться с кем-чем
해내다	beat; defeat; vanquis
천재	天才; природный талант; гений; ~적 гениальный; талантливый; одарённый; 어학의 ~ талантливый лингвист; человек с исключительными способностями к языкам; ; 천재 天災; стихийное бедствие; небесная кара; ; 천재 天災; стихийное бедствие; небесная кара
계교	scheme; a trick; a design;
자수	刺繡; вышивка; вышивание; ~하다 вышивать что на чём; ; 자수 自首; явка с повинной; добровольная сдача; ~하다 являться с повинной; признаваться в преступлении; 범인이 경찰에 ~하다 Преступник явился с повинной в полицейский участок.
따지다	докапываться; разбираться в чем-либо; скрупулёзно расспрашивать
미수죄	未遂罪
근본	根本; 1. основа; корень; 2. прошлое; прошлая жизнь; ~적 основной; коренной; основательный; радикальный; ~적으로 в корне; коренным образом; радикально; ~적인 문제 основной вопрос; ~적인 전환 коренной переворот; ~이 되다 ложиться в основу чего; ~부터 잘못하다 в корне ошибаться
신변	身邊; тело; ~이 위험하다 быть в опасности о ком; ~을 걱정하다 беспокоиться о (чьей) безопасности; ~ 보호 охрана кого
성립	成立; образование; формирование; состаапение; ~하다 образовываться; формироваться; составляться; заключать; ~되다 заключать договор (торг)
혐의	嫌疑; подозрение; ~가 있는 подозрительный; ...의 ~로 по подозрению в чём; ~를 두다 подозревать кого в чем; ~를 받다 быть под подозрением (на подозрении) у кого; подозреваться; 그에게 ~가 떨어졌다 На него пало подозрение.
벋다	торчать; выступать; простираться; тянуться
복수심	復讐心; чувство мести
고백	告白; признание (вины, ошибки); раскаивание; покаяние; исповедь; ~하다 признаваться; сознаваться; исповедовать, исповедоваться; 죄상을 ~하다 заявлять о признании вины; 그는 그녀에게 사랑을 ~했다 Он признался ей в любви.; ~성사 таинство епитимьи; ~소설 повесть-исповедь
되살아나다	заново рождаться; возрождаться
애정	哀情; чувство жалости; жалостливость; ; 애정 愛情; любовь; чувство любви; привязанность
솟아나다	появляться; возвышаться; подниматься; вырастать; 강변에 새로운 공장들이 솟아났다 На берегу вырос новый завод.; 새로운 힘이 솟아난다 Прилив новых сил.
일일이	всё; подробно; детально; один за другим; ~ 간섭하다 во всё вмешиваться
완치	完治; излечение; ~가 가능한 излечимый; ~하다 полностью излечиться; вылечиться; ~의 희망이 없다 Нет надежды на излечение.
미수	尾數; (досл.) количество хвостов (о количестве рыбы в упаковке, коробке); ; 미수 未收; ещё не получить; ; 미수 未遂; не добиваться; не достигать; 방화 ~로 잡히다 быть схваченным при попытке совершить поджог
기껏해야	от силы; самое большее; ~ 그녀는 열 여섯 살 밖에 안된다 Ей от силы шестнадцать лет.
집행	執行; приведение в исполнение; выполнение; ~하다 приводить в исполнение; исполнять; выполнять; конфисковать (имущество) за долги; ~ 기관 исполнительный орган; ~ 명령서 исполнительный лист; ~ 유예 отсрочка приведения в исполнение (приговора); условное осуждение; ~ 위원회 исполнительный комитет; ~처분 принудительная мера
매섭다	бессердечный; лютый; свирепый
처벌	處罰; наказание; кара; взыскание; ~하다 наказывать; карать; взыскивать; 도둑들은 ~되지 않았다 Воры остались ненаказанными.
인정	人情; человеческое чувство; человеколюбие; сердечность; ~이 많다 сердечный; задушевный; 그는 ~이 없다 У него нет сердца; ~이 있다 внимательный к людям; ; 인정 認定; утверждение; признание; квалификация; ~하다 утверждать; признавать; квалифицировать как; 자신의 패배를 ~하다 признать себя побеждённым
몰리다	быть загнанным (куда); быть гонимым; накапливаться; 일에 몰리다 работа поджимает
가느다랗다	быть тонким; стройным; 가느다란 실 очень тонкая нить; 가느다란 미소 едва заметная улыбка
바르르	~ 떨다 слегка дрожать
그저	1. все еще; все время; постоянно; всегда; без остановки; ~ 책을 읽고 있다 Он все еще читает книгу.; 아침부터 ~ 잠만 자고 있다 Он спит с самого утра.; 그는 ~ 부모에게 걱정만 끼치고 있다 Он постоянно приносит только беспокойства родителям.; 2. безразлично; случайно; бесцельно; только; лишь; ~ 앉아 있다 Он равнодушно сидит.; 그는 ~ 웃기만 하였다 Он улыбался, не говоря ни слова.; 3. так себе; все в порядке; ~ 그럴 줄 알았지 Это то, о чем я думал.; ~ 쓸만하다 быть сносным
울먹거리다	чуть не плакать; быть готовым расплакаться
헤매다	бродить; шататься; скитаться; перескакивать с одной мысли на другую; метаться
거지	нищий; попрошайка; ~ 같다 быть похожим на нищего; худший; грубый; ~같이 как нищий; ~ 발싸개 дрянь
은혜	恩惠; милость; благодеяние; ~롭다 благодетельный; милостивый; ~를 베풀다 сделать кому благодеяние; благодетельствовать кому; ~를 입다 быть обязанным кому
부두	埠頭; пристань; причал
빼앗기다	отбирать; отнимать; 권력을 ~ отнимать власть; 돈을 ~ отнимать деньги
꽝	~하다 бухнуть; грохнуть; 그는 주먹으로 방문을 ~ 쳤다 Он стукнул кулаком в дверь.
오므리다	вдавить; заправлять внутрь; поджимать
쑥스럽다	глупый и развязный; постыдный